//MAP CONVERTED BY dmm2tgm.py THIS HEADER COMMENT PREVENTS RECONVERSION, DO NOT REMOVE
"a" = (
/turf/template_noop,
/area/template_noop)
"b" = (
/turf/closed/wall,
/area/template_noop)
"c" = (
/turf/open/floor/iron,
/area/template_noop)
"d" = (
/obj/effect/spawner/structure/window/reinforced/shuttle,
/turf/open/floor/plating,
/area/template_noop)
"g" = (
/obj/effect/spawner/structure/window/reinforced,
/turf/open/floor/plating,
/area/template_noop)
"k" = (
/turf/open/floor/plating,
/area/template_noop)
"l" = (
/turf/closed/indestructible/binary,
/area/template_noop)
"o" = (
/obj/machinery/door/poddoor/shutters/indestructible{
	dir = 1;
	name = "Residential Lockdown"
	},
/turf/open/floor/wood,
/area/template_noop)
"t" = (
/turf/open/space/basic,
/area/template_noop)
"v" = (
/obj/machinery/door/airlock/external/glass/ruin{
	name = "Shuttle Dock"
	},
/obj/effect/mapping_helpers/airlock/cyclelink_helper{
	dir = 8
	},
/turf/open/floor/iron,
/area/template_noop)
"A" = (
/turf/open/floor/wood,
/area/template_noop)
"B" = (
/turf/open/floor/iron/freezer,
/area/template_noop)
"D" = (
/obj/machinery/door/airlock/shuttle/glass{
	name = "Custodial Shuttle"
	},
/turf/open/floor/iron/white,
/area/template_noop)
"E" = (
/turf/open/floor/iron/white,
/area/template_noop)
"F" = (
/obj/structure/window/reinforced/spawner/directional/south,
/turf/open/floor/iron,
/area/template_noop)
"J" = (
/turf/open/floor/iron/white/textured_large,
/area/template_noop)
"L" = (
/obj/machinery/door/airlock/external/glass/ruin{
	name = "Shuttle Dock"
	},
/obj/effect/mapping_helpers/airlock/cyclelink_helper{
	dir = 4
	},
/turf/open/floor/iron,
/area/template_noop)
"O" = (
/obj/structure/window/reinforced/spawner/directional/north,
/turf/open/floor/iron,
/area/template_noop)
"R" = (
/turf/open/floor/wood/large,
/area/template_noop)
"X" = (
/turf/closed/wall/mineral/titanium/interior,
/area/template_noop)

(1,1,1) = {"
a
a
a
a
a
a
a
a
a
a
a
a
a
a
a
a
a
a
a
a
a
a
a
a
a
a
a
a
a
a
a
a
a
a
a
a
a
a
a
a
a
a
a
a
a
a
a
a
a
a
a
a
a
a
a
"}
(2,1,1) = {"
a
a
a
a
a
a
a
a
a
a
a
a
a
a
a
a
a
a
a
a
a
a
a
a
a
a
a
a
a
a
a
a
a
a
a
a
a
a
a
a
a
a
a
a
a
a
a
a
a
a
a
a
a
a
a
"}
(3,1,1) = {"
a
a
a
a
a
a
a
a
a
a
a
a
a
a
a
a
a
a
a
a
a
a
a
a
a
a
a
a
a
a
a
a
a
a
a
a
a
a
a
a
a
a
a
a
a
a
a
a
a
a
a
a
a
a
a
"}
(4,1,1) = {"
a
a
a
a
a
a
a
a
a
a
a
a
a
a
a
a
a
a
a
a
a
a
a
a
a
a
a
a
a
a
a
a
a
a
a
a
a
a
a
a
a
a
a
a
a
a
a
a
a
a
a
a
a
a
a
"}
(5,1,1) = {"
a
a
a
a
a
a
a
a
a
a
a
a
a
a
a
a
a
a
a
a
a
a
a
a
a
a
a
a
a
a
a
a
a
a
a
a
a
a
a
a
a
a
a
a
a
a
a
a
a
a
a
a
a
a
a
"}
(6,1,1) = {"
a
a
a
a
a
a
a
a
a
a
a
a
a
a
a
a
a
a
a
a
a
a
a
a
a
a
a
a
a
a
a
a
a
a
a
a
a
a
a
a
a
a
a
a
a
a
a
a
a
a
a
a
a
a
a
"}
(7,1,1) = {"
a
a
a
a
a
a
a
a
a
a
a
a
a
a
a
a
a
a
a
a
a
a
a
a
a
a
a
a
a
a
a
a
a
a
a
a
a
a
a
a
a
a
a
a
a
a
a
a
a
a
a
a
a
a
a
"}
(8,1,1) = {"
a
a
a
a
a
a
a
a
a
a
a
a
a
a
a
a
a
a
a
a
a
a
a
a
a
a
a
a
a
a
a
a
a
a
a
a
a
a
a
a
a
a
a
a
a
a
a
a
a
a
a
a
a
a
a
"}
(9,1,1) = {"
a
a
a
a
a
a
a
a
a
a
a
a
a
a
a
a
a
a
a
a
a
a
a
a
a
a
a
a
a
a
a
a
a
a
a
a
a
a
a
a
a
a
a
a
a
a
a
a
a
a
a
a
a
a
a
"}
(10,1,1) = {"
a
a
a
a
a
a
a
a
a
a
a
a
a
a
a
a
a
a
a
a
a
a
a
a
a
a
a
a
a
a
a
a
a
a
a
a
a
a
a
a
a
a
a
a
a
a
a
a
a
a
a
a
a
a
a
"}
(11,1,1) = {"
a
a
a
a
a
a
a
a
a
a
a
a
a
a
a
a
a
a
a
a
a
a
a
a
a
a
a
a
a
a
a
a
a
a
a
a
a
a
a
a
a
a
a
a
a
a
a
a
a
a
a
a
a
a
a
"}
(12,1,1) = {"
a
a
a
a
a
a
a
a
a
a
a
a
a
a
a
a
a
a
a
a
a
a
a
a
a
a
a
a
a
a
a
a
a
a
a
a
a
a
a
a
a
a
a
a
a
a
a
a
a
a
a
a
a
a
a
"}
(13,1,1) = {"
a
a
a
a
a
a
a
a
a
a
a
a
a
a
a
a
a
a
a
a
a
a
a
a
a
k
k
k
k
k
a
a
a
a
a
a
a
a
a
a
a
a
a
a
a
a
a
a
a
a
a
a
a
a
a
"}
(14,1,1) = {"
a
a
a
a
a
a
a
a
a
a
a
a
a
a
a
a
a
a
a
a
a
a
a
a
a
k
k
k
k
k
a
a
a
a
a
a
a
a
a
a
a
a
a
a
a
a
a
a
a
a
a
a
a
a
a
"}
(15,1,1) = {"
a
a
a
a
a
a
a
a
a
a
a
a
a
a
a
a
a
a
a
a
a
a
a
a
a
k
k
k
k
k
a
a
a
a
a
a
a
a
a
a
a
a
a
a
a
a
a
a
a
a
a
a
a
a
a
"}
(16,1,1) = {"
a
a
a
a
a
a
a
a
a
a
a
a
a
a
a
a
a
a
a
a
a
a
a
a
a
k
k
k
k
k
a
a
a
a
a
a
a
a
a
a
a
a
a
a
a
a
a
a
a
a
a
a
a
a
a
"}
(17,1,1) = {"
a
a
a
a
a
a
a
a
a
a
a
a
a
a
a
a
a
a
a
a
a
a
a
c
c
c
c
c
c
c
c
c
a
a
a
a
a
a
a
a
a
a
a
a
a
a
a
a
a
a
a
a
a
a
a
"}
(18,1,1) = {"
a
a
a
a
a
a
a
a
a
a
a
a
a
a
a
a
a
a
a
a
a
a
a
c
c
c
c
c
c
c
c
c
a
a
a
a
a
a
a
a
a
a
a
a
a
a
a
a
a
a
a
a
a
a
a
"}
(19,1,1) = {"
a
a
a
a
a
a
a
a
a
a
a
a
a
a
a
a
c
c
c
c
c
c
c
c
c
c
c
c
c
c
c
c
c
c
c
c
c
c
c
b
b
b
b
b
b
b
b
b
b
b
b
b
a
a
a
"}
(20,1,1) = {"
a
a
a
a
a
a
a
a
a
a
a
a
a
a
a
a
c
c
c
c
c
c
c
c
c
c
c
c
c
c
c
c
c
c
c
c
c
c
c
b
B
B
B
b
B
B
B
b
B
B
B
b
a
a
a
"}
(21,1,1) = {"
a
a
a
a
a
a
a
a
a
a
a
a
a
a
a
a
c
c
c
c
c
c
c
c
c
c
c
c
c
c
c
c
c
c
c
c
c
c
c
b
B
B
B
b
B
B
B
b
B
B
B
b
a
a
a
"}
(22,1,1) = {"
a
a
a
a
a
a
a
a
a
a
a
k
k
k
k
k
c
c
c
b
g
g
g
g
b
L
b
g
b
L
b
g
g
g
g
b
c
c
c
b
R
R
R
b
R
R
R
b
R
R
R
b
a
a
a
"}
(23,1,1) = {"
a
a
a
a
a
a
a
a
a
a
a
k
k
k
k
k
c
c
c
g
t
t
t
t
O
c
F
t
O
c
F
t
t
t
t
g
c
c
c
b
R
R
R
b
R
R
R
b
R
R
R
b
a
a
a
"}
(24,1,1) = {"
a
a
a
a
a
a
a
a
a
a
a
k
k
k
k
k
c
c
c
g
t
t
t
t
b
v
b
t
b
v
b
t
t
t
t
g
c
c
c
b
R
R
R
b
R
R
R
b
R
R
R
b
a
a
a
"}
(25,1,1) = {"
a
a
a
a
a
a
a
a
a
a
a
k
k
k
k
k
c
c
c
g
t
t
X
X
X
D
d
d
d
D
X
X
X
t
t
g
c
c
c
b
R
R
R
b
R
R
R
b
R
R
R
b
a
a
a
"}
(26,1,1) = {"
a
a
a
a
a
a
a
a
a
a
a
k
k
k
k
k
c
c
c
g
t
t
X
E
E
E
E
E
E
E
E
E
X
t
t
g
c
c
A
b
b
A
b
b
b
A
b
b
b
A
b
b
b
b
l
"}
(27,1,1) = {"
a
a
a
a
a
a
a
a
a
a
a
k
k
k
k
k
c
c
c
g
t
t
d
E
E
E
E
E
E
E
E
E
d
t
t
g
c
c
A
A
A
A
A
A
A
A
A
A
A
A
A
A
o
b
l
"}
(28,1,1) = {"
a
a
a
a
a
a
a
a
a
a
a
k
k
k
k
k
c
c
c
g
t
t
d
E
E
E
E
J
E
E
E
E
d
t
t
g
c
c
A
R
R
R
R
R
R
R
R
R
R
R
R
R
o
b
l
"}
(29,1,1) = {"
a
a
a
a
a
a
a
a
a
a
a
k
k
k
k
k
c
c
c
g
t
t
d
E
E
E
E
E
E
E
E
E
d
t
t
g
c
c
A
A
A
A
A
A
A
A
A
A
A
A
A
A
o
b
l
"}
(30,1,1) = {"
a
a
a
a
a
a
a
a
a
a
a
k
k
k
k
k
c
c
c
g
t
t
X
E
E
E
E
E
E
E
E
E
X
t
t
g
c
c
A
b
b
A
b
b
b
A
b
b
b
A
b
b
b
b
l
"}
(31,1,1) = {"
a
a
a
a
a
a
a
a
a
a
a
k
k
k
k
k
c
c
c
g
t
t
X
X
X
D
d
d
d
D
X
X
X
t
t
g
c
c
c
b
R
R
R
b
R
R
R
b
R
R
R
b
a
a
a
"}
(32,1,1) = {"
a
a
a
a
a
a
a
a
a
a
a
k
k
k
k
k
c
c
c
g
t
t
t
t
b
L
b
t
b
L
b
t
t
t
t
g
c
c
c
b
R
R
R
b
R
R
R
b
R
R
R
b
a
a
a
"}
(33,1,1) = {"
a
a
a
a
a
a
a
a
a
a
a
k
k
k
k
k
c
c
c
g
t
t
t
t
O
c
F
t
O
c
F
t
t
t
t
g
c
c
c
b
R
R
R
b
R
R
R
b
R
R
R
b
a
a
a
"}
(34,1,1) = {"
a
a
a
a
a
a
a
a
a
a
a
k
k
k
k
k
c
c
c
b
g
g
g
g
b
v
b
g
b
v
b
g
g
g
g
b
c
c
c
b
R
R
R
b
R
R
R
b
R
R
R
b
a
a
a
"}
(35,1,1) = {"
a
a
a
a
a
a
a
a
a
a
a
a
a
a
a
a
c
c
c
c
c
c
c
c
c
c
c
c
c
c
c
c
c
c
c
c
c
c
c
b
B
B
B
b
B
B
B
b
B
B
B
b
a
a
a
"}
(36,1,1) = {"
a
a
a
a
a
a
a
a
a
a
a
a
a
a
a
a
c
c
c
c
c
c
c
c
c
c
c
c
c
c
c
c
c
c
c
c
c
c
c
b
B
B
B
b
B
B
B
b
B
B
B
b
a
a
a
"}
(37,1,1) = {"
a
a
a
a
a
a
a
a
a
a
a
a
a
a
a
a
c
c
c
c
c
c
c
c
c
c
c
c
c
c
c
c
c
c
c
c
c
c
c
b
b
b
b
b
b
b
b
b
b
b
b
b
a
a
a
"}
(38,1,1) = {"
a
a
a
a
a
a
a
a
a
a
a
a
a
a
a
a
a
a
a
a
a
a
a
c
c
c
c
c
c
c
c
c
a
a
a
a
a
a
a
a
a
a
a
a
a
a
a
a
a
a
a
a
a
a
a
"}
(39,1,1) = {"
a
a
a
a
a
a
a
a
a
a
a
a
a
a
a
a
a
a
a
a
a
a
a
c
c
c
c
c
c
c
c
c
a
a
a
a
a
a
a
a
a
a
a
a
a
a
a
a
a
a
a
a
a
a
a
"}
(40,1,1) = {"
a
a
a
a
a
a
a
a
a
a
a
a
a
a
a
a
a
a
a
a
a
a
a
a
a
k
k
k
k
k
a
a
a
a
a
a
a
a
a
a
a
a
a
a
a
a
a
a
a
a
a
a
a
a
a
"}
(41,1,1) = {"
a
a
a
a
a
a
a
a
a
a
a
a
a
a
a
a
a
a
a
a
a
a
a
a
a
k
k
k
k
k
a
a
a
a
a
a
a
a
a
a
a
a
a
a
a
a
a
a
a
a
a
a
a
a
a
"}
(42,1,1) = {"
a
a
a
a
a
a
a
a
a
a
a
a
a
a
a
a
a
a
a
a
a
a
a
a
a
k
k
k
k
k
a
a
a
a
a
a
a
a
a
a
a
a
a
a
a
a
a
a
a
a
a
a
a
a
a
"}
(43,1,1) = {"
a
a
a
a
a
a
a
a
a
a
a
a
a
a
a
a
a
a
a
a
a
a
a
a
a
k
k
k
k
k
a
a
a
a
a
a
a
a
a
a
a
a
a
a
a
a
a
a
a
a
a
a
a
a
a
"}
(44,1,1) = {"
a
a
a
a
a
a
a
a
a
a
a
a
a
a
a
a
a
a
a
a
a
a
a
a
a
a
a
a
a
a
a
a
a
a
a
a
a
a
a
a
a
a
a
a
a
a
a
a
a
a
a
a
a
a
a
"}
(45,1,1) = {"
a
a
a
a
a
a
a
a
a
a
a
a
a
a
a
a
a
a
a
a
a
a
a
a
a
a
a
a
a
a
a
a
a
a
a
a
a
a
a
a
a
a
a
a
a
a
a
a
a
a
a
a
a
a
a
"}
(46,1,1) = {"
a
a
a
a
a
a
a
a
a
a
a
a
a
a
a
a
a
a
a
a
a
a
a
a
a
a
a
a
a
a
a
a
a
a
a
a
a
a
a
a
a
a
a
a
a
a
a
a
a
a
a
a
a
a
a
"}
(47,1,1) = {"
a
a
a
a
a
a
a
a
a
a
a
a
a
a
a
a
a
a
a
a
a
a
a
a
a
a
a
a
a
a
a
a
a
a
a
a
a
a
a
a
a
a
a
a
a
a
a
a
a
a
a
a
a
a
a
"}
(48,1,1) = {"
a
a
a
a
a
a
a
a
a
a
a
a
a
a
a
a
a
a
a
a
a
a
a
a
a
a
a
a
a
a
a
a
a
a
a
a
a
a
a
a
a
a
a
a
a
a
a
a
a
a
a
a
a
a
a
"}
(49,1,1) = {"
a
a
a
a
a
a
a
a
a
a
a
a
a
a
a
a
a
a
a
a
a
a
a
a
a
a
a
a
a
a
a
a
a
a
a
a
a
a
a
a
a
a
a
a
a
a
a
a
a
a
a
a
a
a
a
"}
(50,1,1) = {"
a
a
a
a
a
a
a
a
a
a
a
a
a
a
a
a
a
a
a
a
a
a
a
a
a
a
a
a
a
a
a
a
a
a
a
a
a
a
a
a
a
a
a
a
a
a
a
a
a
a
a
a
a
a
a
"}
(51,1,1) = {"
a
a
a
a
a
a
a
a
a
a
a
a
a
a
a
a
a
a
a
a
a
a
a
a
a
a
a
a
a
a
a
a
a
a
a
a
a
a
a
a
a
a
a
a
a
a
a
a
a
a
a
a
a
a
a
"}
(52,1,1) = {"
a
a
a
a
a
a
a
a
a
a
a
a
a
a
a
a
a
a
a
a
a
a
a
a
a
a
a
a
a
a
a
a
a
a
a
a
a
a
a
a
a
a
a
a
a
a
a
a
a
a
a
a
a
a
a
"}
(53,1,1) = {"
a
a
a
a
a
a
a
a
a
a
a
a
a
a
a
a
a
a
a
a
a
a
a
a
a
a
a
a
a
a
a
a
a
a
a
a
a
a
a
a
a
a
a
a
a
a
a
a
a
a
a
a
a
a
a
"}
(54,1,1) = {"
a
a
a
a
a
a
a
a
a
a
a
a
a
a
a
a
a
a
a
a
a
a
a
a
a
a
a
a
a
a
a
a
a
a
a
a
a
a
a
a
a
a
a
a
a
a
a
a
a
a
a
a
a
a
a
"}
(55,1,1) = {"
a
a
a
a
a
a
a
a
a
a
a
a
a
a
a
a
a
a
a
a
a
a
a
a
a
a
a
a
a
a
a
a
a
a
a
a
a
a
a
a
a
a
a
a
a
a
a
a
a
a
a
a
a
a
a
"}
