//MAP CONVERTED BY dmm2tgm.py THIS HEADER COMMENT PREVENTS RECONVERSION, DO NOT REMOVE
"as" = (
/turf/closed/wall/r_wall,
/area/template_noop)
"aO" = (
/obj/structure/sign/poster/contraband/fun_police/directional/west,
/obj/item/screwdriver{
	pixel_x = 7;
	pixel_y = -7
	},
/turf/open/floor/wood/large,
/area/template_noop)
"cx" = (
/obj/effect/turf_decal/siding/wood{
	dir = 8
	},
/turf/open/floor/iron,
/area/template_noop)
"dL" = (
/turf/open/floor/plating/elevatorshaft,
/area/template_noop)
"dO" = (
/obj/structure/toilet{
	dir = 4
	},
/turf/open/floor/iron/freezer,
/area/template_noop)
"en" = (
/obj/machinery/shower/directional/west,
/turf/open/floor/iron/freezer,
/area/template_noop)
"eR" = (
/obj/effect/turf_decal/siding/wood{
	dir = 8
	},
/turf/open/floor/wood/large,
/area/template_noop)
"fH" = (
/obj/structure/bed{
	dir = 1
	},
/obj/item/bedsheet/rev{
	dir = 1
	},
/turf/open/floor/wood/large,
/area/template_noop)
"fW" = (
/obj/structure/window/reinforced/spawner/directional/south,
/turf/open/floor/iron,
/area/template_noop)
"ho" = (
/obj/machinery/door/airlock/external/glass/ruin{
	name = "Shuttle Dock"
	},
/obj/effect/mapping_helpers/airlock/cyclelink_helper{
	dir = 4
	},
/turf/open/floor/iron,
/area/template_noop)
"hv" = (
/turf/template_noop,
/area/template_noop)
"hW" = (
/obj/structure/bed{
	dir = 1
	},
/obj/item/bedsheet/rainbow{
	dir = 1
	},
/turf/open/floor/wood/large,
/area/template_noop)
"ic" = (
/obj/effect/turf_decal/siding/wood/corner{
	dir = 8
	},
/turf/open/floor/iron,
/area/template_noop)
"kC" = (
/obj/effect/mob_spawn/corpse/human/scientist,
/obj/effect/decal/cleanable/blood/bubblegum{
	icon_state = "floor5"
	},
/turf/open/floor/iron/freezer,
/area/template_noop)
"mI" = (
/obj/machinery/button/door/directional/west{
	name = "Main Elevator Call Button";
	req_access = list("inaccessible")
	},
/turf/open/floor/iron,
/area/template_noop)
"ne" = (
/obj/structure/sign/poster/contraband/singletank_bomb/directional/south,
/turf/open/floor/wood/large,
/area/template_noop)
"nf" = (
/obj/structure/dresser,
/obj/structure/sign/poster/contraband/self_ai_liberation/directional/north,
/obj/structure/sign/poster/contraband/gorlex_recruitment/directional/west,
/turf/open/floor/wood/large,
/area/template_noop)
"nl" = (
/obj/effect/spawner/structure/window/reinforced,
/turf/open/floor/plating,
/area/template_noop)
"nu" = (
/obj/structure/sink/directional/south,
/turf/open/floor/iron/freezer,
/area/template_noop)
"nH" = (
/obj/machinery/door/airlock/maintenance{
	name = "Cloning Maintenance"
	},
/turf/open/floor/plating,
/area/template_noop)
"oc" = (
/obj/structure/window/reinforced/spawner/directional/north,
/turf/open/floor/iron,
/area/template_noop)
"pd" = (
/turf/open/floor/iron,
/area/template_noop)
"pt" = (
/turf/open/floor/iron/white/textured_large,
/area/template_noop)
"pK" = (
/obj/effect/turf_decal/siding/wood{
	dir = 8
	},
/obj/effect/turf_decal/siding/wood{
	dir = 4
	},
/obj/machinery/door/airlock/wood,
/turf/open/floor/iron/sepia,
/area/template_noop)
"qw" = (
/obj/structure/window/reinforced/tinted/spawner/directional/east,
/turf/open/floor/iron/freezer,
/area/template_noop)
"qW" = (
/obj/structure/window/reinforced/tinted/spawner/directional/west,
/turf/open/floor/iron/freezer,
/area/template_noop)
"sG" = (
/obj/structure/bed,
/obj/item/bedsheet/pirate,
/turf/open/floor/wood/large,
/area/template_noop)
"sO" = (
/turf/open/floor/iron/freezer,
/area/template_noop)
"tn" = (
/obj/structure/dresser,
/turf/open/floor/wood/large,
/area/template_noop)
"va" = (
/turf/open/floor/plating,
/area/template_noop)
"wr" = (
/obj/structure/toilet{
	dir = 8
	},
/turf/open/floor/iron/freezer,
/area/template_noop)
"xa" = (
/turf/closed/indestructible/binary,
/area/template_noop)
"yD" = (
/obj/effect/decal/cleanable/blood/drip,
/obj/effect/decal/cleanable/blood/drip{
	pixel_x = 14;
	pixel_y = -4
	},
/obj/effect/decal/cleanable/blood/tracks{
	dir = 4
	},
/obj/effect/decal/cleanable/blood/drip{
	pixel_x = 2;
	pixel_y = 15
	},
/turf/open/floor/wood/large,
/area/template_noop)
"yI" = (
/obj/machinery/door/airlock/medical{
	name = "Reception Desk"
	},
/turf/open/floor/plating,
/area/template_noop)
"zR" = (
/turf/closed/wall/mineral/titanium/interior,
/area/template_noop)
"Ai" = (
/obj/effect/turf_decal/siding/wood{
	dir = 4
	},
/obj/effect/turf_decal/siding/wood{
	dir = 8
	},
/turf/open/floor/wood/large,
/area/template_noop)
"AA" = (
/turf/closed/wall/mineral/iron,
/area/template_noop)
"AL" = (
/obj/structure/table/abductor,
/obj/item/toy/plush/abductor,
/turf/open/floor/plating/elevatorshaft,
/area/template_noop)
"BI" = (
/turf/open/space/basic,
/area/template_noop)
"DV" = (
/obj/structure/sign/poster/contraband/syndicate_recruitment/directional/north,
/obj/item/assembly/igniter{
	pixel_x = -5;
	pixel_y = -4
	},
/turf/open/floor/wood/large,
/area/template_noop)
"ET" = (
/obj/effect/spawner/structure/window/reinforced/shuttle,
/turf/open/floor/plating,
/area/template_noop)
"Ft" = (
/turf/open/floor/iron/textured_large,
/area/template_noop)
"Fz" = (
/obj/effect/turf_decal/siding/wood{
	dir = 4
	},
/turf/open/floor/wood/large,
/area/template_noop)
"Gh" = (
/obj/machinery/door/poddoor{
	name = "Residential Elevator"
	},
/turf/open/floor/iron/textured_large,
/area/template_noop)
"GT" = (
/obj/structure/falsewall/iron,
/turf/open/floor/plating,
/area/template_noop)
"Hf" = (
/obj/structure/bed,
/obj/item/bedsheet/cosmos,
/turf/open/floor/wood/large,
/area/template_noop)
"Im" = (
/obj/machinery/shower/directional/east,
/turf/open/floor/iron/freezer,
/area/template_noop)
"JP" = (
/turf/open/floor/wood,
/area/template_noop)
"Ki" = (
/obj/machinery/door/airlock/medical{
	name = "Cloning Lab"
	},
/obj/effect/mapping_helpers/airlock/locked,
/turf/open/floor/plating,
/area/template_noop)
"Ks" = (
/obj/effect/decal/cleanable/glass,
/obj/effect/decal/cleanable/blood/tracks{
	dir = 4
	},
/obj/effect/decal/cleanable/blood/drip{
	pixel_x = 14;
	pixel_y = -4
	},
/obj/effect/decal/cleanable/blood/drip{
	pixel_x = -6;
	pixel_y = 6
	},
/turf/open/floor/iron/freezer,
/area/template_noop)
"Lh" = (
/obj/machinery/door/airlock/engineering{
	name = "Maintenance Closet"
	},
/turf/open/floor/plating,
/area/template_noop)
"Nd" = (
/obj/machinery/door/poddoor{
	name = "Main Elevator";
	id = "bitrunning_jani_lift"
	},
/turf/open/floor/iron/textured_large,
/area/template_noop)
"NJ" = (
/turf/closed/wall,
/area/template_noop)
"Oh" = (
/obj/effect/spawner/structure/window/reinforced/tinted,
/turf/open/floor/plating,
/area/template_noop)
"Or" = (
/obj/structure/table/abductor,
/obj/item/toy/plush/abductor/agent,
/turf/open/floor/plating/elevatorshaft,
/area/template_noop)
"Ov" = (
/obj/effect/turf_decal/siding/wood,
/turf/open/floor/iron,
/area/template_noop)
"Pg" = (
/obj/effect/decal/cleanable/blood/drip{
	pixel_x = -4;
	pixel_y = -6
	},
/obj/structure/sink/directional/south,
/obj/item/tank/internals/plasma/empty{
	pixel_x = 7;
	pixel_y = -5
	},
/turf/open/floor/iron/freezer,
/area/template_noop)
"QS" = (
/turf/open/floor/wood/large,
/area/template_noop)
"Ry" = (
/obj/effect/turf_decal/siding/wood/corner,
/turf/open/floor/iron,
/area/template_noop)
"Tb" = (
/obj/machinery/door/airlock/medical{
	name = "Cloning Lab"
	},
/turf/open/floor/plating,
/area/template_noop)
"Tq" = (
/obj/item/ammo_casing/a223{
	pixel_x = 5;
	pixel_y = -8
	},
/obj/item/ammo_casing/a223{
	dir = 4;
	pixel_x = -8;
	pixel_y = 9
	},
/obj/item/ammo_casing/a223{
	dir = 10;
	pixel_x = -5;
	pixel_y = -2
	},
/obj/item/ammo_casing/a223{
	dir = 6;
	pixel_x = -6;
	pixel_y = 3
	},
/obj/item/ammo_casing/a223{
	dir = 8;
	pixel_x = 9;
	pixel_y = -4
	},
/obj/item/ammo_casing/a223{
	dir = 4;
	pixel_x = -13;
	pixel_y = -10
	},
/obj/item/ammo_casing/a223{
	dir = 1;
	pixel_x = 13;
	pixel_y = 8
	},
/obj/item/ammo_casing/a223{
	dir = 8;
	pixel_x = -6;
	pixel_y = -13
	},
/obj/item/ammo_casing/a223{
	dir = 6;
	pixel_x = 4;
	pixel_y = 2
	},
/turf/open/floor/wood/large,
/area/template_noop)
"Up" = (
/obj/structure/bed{
	dir = 1
	},
/obj/item/bedsheet/grey{
	dir = 1
	},
/turf/open/floor/wood/large,
/area/template_noop)
"Uy" = (
/obj/machinery/door/airlock/external/glass/ruin{
	name = "Shuttle Dock"
	},
/obj/effect/mapping_helpers/airlock/cyclelink_helper{
	dir = 8
	},
/turf/open/floor/iron,
/area/template_noop)
"Vp" = (
/obj/effect/turf_decal/siding/wood/end,
/turf/open/floor/wood/large,
/area/template_noop)
"Vr" = (
/obj/machinery/door/airlock/engineering{
	name = "Elevator Maintenance"
	},
/turf/open/floor/plating/reinforced,
/area/template_noop)
"VR" = (
/obj/machinery/door/airlock/shuttle/glass{
	name = "Custodial Shuttle"
	},
/turf/open/floor/iron/white,
/area/template_noop)
"Wn" = (
/obj/machinery/door/airlock/hatch{
	name = "Ventilation Access"
	},
/turf/open/floor/plating,
/area/template_noop)
"Wv" = (
/obj/structure/bed,
/obj/item/bedsheet/patriot,
/turf/open/floor/wood/large,
/area/template_noop)
"WD" = (
/turf/open/floor/plating/reinforced,
/area/template_noop)
"WY" = (
/obj/machinery/button/door/directional/east{
	req_access = list("inaccessible");
	name = "Residential Elevator Call Button"
	},
/turf/open/floor/wood,
/area/template_noop)
"Xp" = (
/obj/effect/turf_decal/siding/wood{
	dir = 4
	},
/turf/open/floor/iron,
/area/template_noop)
"Xq" = (
/obj/structure/grille/indestructible,
/turf/open/floor/plating,
/area/template_noop)
"XR" = (
/obj/effect/decal/cleanable/blood/bubblegum,
/obj/effect/decal/cleanable/blood/drip{
	pixel_x = 15;
	pixel_y = 9
	},
/obj/effect/decal/cleanable/blood/drip{
	pixel_x = 12;
	pixel_y = 17
	},
/turf/open/floor/wood/large,
/area/template_noop)
"Zo" = (
/obj/structure/table/abductor,
/obj/item/reagent_containers/pill/style/red,
/turf/open/floor/plating/elevatorshaft,
/area/template_noop)
"Zp" = (
/obj/machinery/door/airlock/medical/glass{
	name = "Cloning Lab"
	},
/turf/open/floor/plating,
/area/template_noop)
"ZC" = (
/obj/effect/turf_decal/siding/wood/end{
	dir = 1
	},
/turf/open/floor/wood/large,
/area/template_noop)
"ZH" = (
/turf/open/floor/iron/white,
/area/template_noop)
"ZI" = (
/obj/effect/turf_decal/siding/wood{
	dir = 4
	},
/obj/effect/decal/cleanable/blood/tracks{
	dir = 8
	},
/obj/effect/decal/cleanable/blood/drip{
	pixel_x = -1;
	pixel_y = 11
	},
/obj/effect/decal/cleanable/blood/drip{
	pixel_x = 10;
	pixel_y = -3
	},
/turf/open/floor/wood/large,
/area/template_noop)

(1,1,1) = {"
hv
hv
hv
hv
hv
hv
hv
hv
hv
hv
hv
hv
hv
hv
hv
hv
hv
hv
hv
hv
hv
hv
hv
xa
xa
xa
xa
xa
xa
xa
hv
hv
hv
hv
hv
hv
hv
hv
hv
hv
hv
hv
hv
hv
hv
hv
hv
hv
hv
hv
hv
hv
hv
hv
hv
"}
(2,1,1) = {"
hv
hv
hv
hv
hv
hv
hv
hv
hv
hv
hv
hv
hv
hv
hv
hv
hv
hv
hv
hv
hv
hv
hv
xa
as
as
as
as
as
xa
hv
hv
hv
hv
hv
hv
hv
hv
hv
hv
hv
hv
hv
hv
hv
hv
hv
hv
hv
hv
hv
hv
hv
hv
hv
"}
(3,1,1) = {"
hv
hv
hv
hv
hv
hv
hv
hv
hv
hv
hv
hv
hv
hv
hv
hv
hv
hv
hv
hv
hv
hv
hv
xa
as
AL
Zo
Or
as
xa
hv
hv
hv
hv
hv
hv
hv
hv
hv
hv
hv
hv
hv
hv
hv
hv
hv
hv
hv
hv
hv
hv
hv
hv
hv
"}
(4,1,1) = {"
hv
hv
hv
hv
hv
hv
hv
hv
hv
hv
hv
hv
hv
hv
hv
hv
hv
hv
hv
hv
hv
hv
xa
xa
as
dL
dL
dL
as
xa
xa
hv
hv
hv
hv
hv
hv
hv
hv
hv
hv
hv
hv
hv
hv
hv
hv
hv
hv
hv
hv
hv
hv
hv
hv
"}
(5,1,1) = {"
hv
hv
hv
hv
hv
hv
hv
hv
hv
hv
hv
hv
hv
hv
hv
hv
hv
hv
hv
hv
hv
hv
xa
NJ
as
Nd
Nd
Nd
as
NJ
xa
hv
hv
hv
hv
hv
hv
hv
hv
hv
hv
hv
hv
hv
hv
hv
hv
hv
hv
hv
hv
hv
hv
hv
hv
"}
(6,1,1) = {"
hv
hv
hv
hv
hv
hv
hv
hv
hv
hv
hv
hv
hv
hv
hv
hv
hv
hv
hv
hv
xa
xa
xa
NJ
mI
pd
pd
pd
pd
NJ
xa
xa
xa
hv
hv
hv
hv
hv
hv
hv
hv
hv
hv
hv
hv
hv
hv
hv
hv
hv
hv
hv
hv
hv
hv
"}
(7,1,1) = {"
hv
hv
xa
xa
xa
xa
xa
xa
xa
xa
xa
xa
xa
xa
xa
xa
hv
hv
hv
hv
xa
NJ
NJ
NJ
pd
pd
pd
pd
pd
NJ
NJ
NJ
xa
hv
hv
hv
hv
hv
hv
hv
hv
hv
hv
hv
hv
hv
hv
hv
hv
hv
hv
hv
hv
hv
hv
"}
(8,1,1) = {"
hv
hv
xa
NJ
NJ
NJ
NJ
NJ
NJ
NJ
NJ
NJ
NJ
NJ
NJ
xa
xa
xa
xa
xa
xa
NJ
pd
pd
pd
pd
pd
pd
pd
pd
pd
NJ
xa
xa
xa
xa
xa
xa
xa
xa
hv
hv
hv
hv
hv
hv
hv
hv
hv
hv
hv
hv
hv
hv
hv
"}
(9,1,1) = {"
hv
hv
xa
NJ
pd
pd
pd
pd
pd
pd
pd
pd
pd
pd
NJ
NJ
NJ
NJ
NJ
NJ
NJ
NJ
pd
pd
pd
pd
pd
pd
pd
pd
pd
NJ
NJ
NJ
NJ
NJ
NJ
NJ
NJ
xa
xa
xa
xa
xa
xa
xa
xa
xa
xa
xa
xa
xa
hv
hv
hv
"}
(10,1,1) = {"
hv
hv
xa
NJ
pd
pd
pd
pd
pd
pd
pd
pd
pd
pd
NJ
pd
pd
pd
pd
pd
pd
pd
pd
pd
pd
pd
pd
pd
pd
pd
pd
pd
pd
pd
pd
pd
pd
pd
NJ
NJ
NJ
NJ
NJ
NJ
NJ
NJ
NJ
NJ
NJ
NJ
NJ
xa
hv
hv
hv
"}
(11,1,1) = {"
hv
hv
xa
NJ
pd
pd
pd
pd
pd
pd
pd
pd
pd
pd
NJ
pd
pd
pd
pd
pd
pd
pd
pd
pd
pd
pd
pd
pd
pd
pd
pd
pd
pd
pd
pd
pd
pd
pd
NJ
Im
sO
dO
NJ
Im
sO
dO
NJ
Im
sO
dO
NJ
xa
hv
hv
hv
"}
(12,1,1) = {"
hv
hv
xa
NJ
pd
pd
pd
pd
pd
NJ
NJ
va
NJ
NJ
NJ
pd
pd
pd
pd
pd
pd
pd
pd
pd
pd
pd
pd
pd
pd
pd
pd
pd
pd
pd
pd
pd
pd
pd
NJ
nu
qw
qw
NJ
nu
qw
qw
NJ
nu
qw
qw
NJ
xa
hv
hv
hv
"}
(13,1,1) = {"
hv
hv
xa
NJ
pd
pd
pd
pd
pd
NJ
pd
pd
pd
pd
pd
pd
pd
pd
NJ
nl
nl
nl
nl
NJ
ho
NJ
nl
NJ
ho
NJ
nl
nl
nl
nl
NJ
pd
pd
pd
NJ
eR
eR
eR
NJ
eR
eR
eR
NJ
eR
eR
eR
NJ
xa
hv
hv
hv
"}
(14,1,1) = {"
xa
xa
xa
NJ
pd
pd
pd
pd
pd
NJ
pd
pd
pd
va
pd
pd
pd
pd
nl
BI
BI
BI
BI
oc
pd
fW
BI
oc
pd
fW
BI
BI
BI
BI
nl
pd
pd
pd
NJ
QS
QS
QS
NJ
QS
QS
QS
NJ
QS
QS
QS
NJ
xa
hv
hv
hv
"}
(15,1,1) = {"
xa
NJ
NJ
NJ
NJ
NJ
pd
pd
pd
NJ
va
va
va
va
pd
pd
pd
pd
nl
BI
BI
BI
BI
NJ
Uy
NJ
BI
NJ
Uy
NJ
BI
BI
BI
BI
nl
pd
pd
pd
NJ
Hf
QS
QS
NJ
Wv
QS
QS
NJ
sG
QS
QS
NJ
xa
hv
hv
hv
"}
(16,1,1) = {"
xa
NJ
pd
pd
pd
NJ
pd
pd
pd
NJ
pd
pd
pd
pd
pd
pd
pd
pd
nl
BI
BI
zR
zR
zR
VR
ET
ET
ET
VR
zR
zR
zR
BI
BI
nl
pd
Ry
Xp
NJ
tn
QS
QS
NJ
tn
QS
QS
NJ
tn
QS
QS
NJ
xa
xa
xa
xa
"}
(17,1,1) = {"
xa
NJ
pd
pd
pd
va
pd
pd
pd
va
pd
pd
pd
pd
pd
pd
pd
pd
nl
BI
BI
zR
ZH
ZH
ZH
ZH
ZH
ZH
ZH
ZH
ZH
zR
BI
BI
nl
pd
Ov
JP
NJ
NJ
pK
NJ
NJ
NJ
pK
NJ
NJ
NJ
pK
NJ
NJ
NJ
NJ
NJ
xa
"}
(18,1,1) = {"
xa
NJ
pd
pd
pd
NJ
pd
pd
pd
va
pd
pd
pd
pd
pd
pd
pd
pd
nl
BI
BI
ET
ZH
ZH
ZH
ZH
ZH
ZH
ZH
ZH
ZH
ET
BI
BI
nl
pd
Ov
JP
JP
JP
JP
JP
JP
JP
JP
JP
JP
JP
JP
JP
JP
JP
Gh
NJ
xa
"}
(19,1,1) = {"
xa
NJ
pd
pd
pd
NJ
NJ
NJ
va
va
pd
pd
pd
pd
pd
pd
pd
pd
nl
BI
BI
ET
ZH
ZH
ZH
ZH
pt
ZH
ZH
ZH
ZH
ET
BI
BI
nl
pd
Ov
JP
ZC
Ai
Ai
Ai
Ai
Ai
Ai
Ai
Ai
Ai
Ai
Ai
Vp
JP
Gh
NJ
xa
"}
(20,1,1) = {"
xa
NJ
NJ
NJ
NJ
NJ
xa
NJ
pd
pd
pd
pd
pd
pd
pd
pd
pd
pd
nl
BI
BI
ET
ZH
ZH
ZH
ZH
ZH
ZH
ZH
ZH
ZH
ET
BI
BI
nl
pd
Ov
JP
JP
JP
JP
JP
JP
JP
JP
JP
JP
JP
JP
JP
JP
WY
Gh
NJ
xa
"}
(21,1,1) = {"
xa
AA
AA
AA
AA
xa
xa
NJ
pd
pd
pd
pd
pd
pd
pd
pd
pd
pd
nl
BI
BI
zR
ZH
ZH
ZH
ZH
ZH
ZH
ZH
ZH
ZH
zR
BI
BI
nl
pd
Ov
JP
NJ
NJ
pK
NJ
NJ
NJ
pK
NJ
NJ
NJ
pK
NJ
NJ
NJ
NJ
NJ
xa
"}
(22,1,1) = {"
xa
AA
va
va
AA
AA
AA
NJ
pd
pd
pd
pd
pd
pd
pd
pd
pd
pd
nl
BI
BI
zR
zR
zR
VR
ET
ET
ET
VR
zR
zR
zR
BI
BI
nl
pd
ic
cx
NJ
nf
Tq
aO
NJ
tn
QS
QS
NJ
tn
QS
QS
NJ
xa
xa
xa
xa
"}
(23,1,1) = {"
xa
AA
va
va
va
va
AA
NJ
pd
pd
pd
pd
pd
pd
pd
pd
pd
pd
nl
BI
BI
BI
BI
NJ
ho
NJ
BI
NJ
ho
NJ
BI
BI
BI
BI
nl
pd
pd
pd
NJ
fH
XR
QS
NJ
hW
QS
QS
NJ
Up
QS
QS
NJ
xa
hv
hv
hv
"}
(24,1,1) = {"
xa
AA
AA
AA
AA
va
AA
NJ
pd
pd
pd
pd
pd
pd
pd
pd
pd
pd
nl
BI
BI
BI
BI
oc
pd
fW
BI
oc
pd
fW
BI
BI
BI
BI
nl
pd
pd
pd
NJ
DV
yD
ne
NJ
QS
QS
QS
NJ
QS
QS
QS
NJ
xa
hv
hv
hv
"}
(25,1,1) = {"
xa
AA
va
va
AA
va
AA
NJ
pd
pd
pd
pd
pd
pd
pd
pd
pd
pd
NJ
nl
nl
nl
nl
NJ
Uy
NJ
nl
NJ
Uy
NJ
nl
nl
nl
nl
NJ
pd
pd
pd
NJ
Fz
ZI
Fz
NJ
Fz
Fz
Fz
NJ
Fz
Fz
Fz
NJ
xa
hv
hv
hv
"}
(26,1,1) = {"
xa
AA
AA
va
AA
va
AA
NJ
NJ
NJ
NJ
NJ
NJ
NJ
NJ
pd
pd
pd
pd
pd
pd
pd
pd
pd
pd
pd
pd
pd
pd
pd
pd
pd
pd
pd
pd
pd
pd
pd
NJ
Pg
Ks
qW
NJ
nu
qW
qW
NJ
nu
qW
qW
NJ
xa
hv
hv
hv
"}
(27,1,1) = {"
xa
AA
va
va
AA
va
AA
AA
AA
AA
NJ
pd
pd
pd
va
pd
pd
pd
pd
pd
pd
pd
pd
pd
pd
pd
pd
pd
pd
pd
pd
pd
pd
pd
pd
pd
pd
pd
NJ
en
kC
wr
NJ
en
sO
wr
NJ
en
sO
wr
NJ
xa
xa
hv
hv
"}
(28,1,1) = {"
xa
AA
va
AA
AA
va
va
va
va
AA
NJ
pd
pd
pd
NJ
pd
pd
pd
pd
pd
pd
pd
pd
pd
pd
pd
pd
pd
pd
pd
pd
pd
pd
pd
pd
pd
pd
pd
as
as
as
as
as
as
as
as
as
as
as
as
as
as
xa
hv
hv
"}
(29,1,1) = {"
xa
AA
va
va
AA
Xq
AA
AA
va
AA
NJ
as
as
as
as
as
va
va
va
va
as
as
pd
pd
pd
pd
pd
pd
pd
pd
pd
NJ
NJ
NJ
NJ
as
as
as
as
pd
pd
pd
pd
as
pd
pd
pd
as
pd
pd
pd
as
xa
hv
hv
"}
(30,1,1) = {"
xa
AA
AA
va
va
va
va
AA
va
AA
AA
as
pd
pd
pd
va
pd
pd
pd
pd
pd
as
pd
pd
pd
pd
pd
pd
pd
pd
pd
NJ
pd
pd
pd
as
pd
pd
pd
pd
pd
pd
pd
yI
pd
pd
pd
nH
pd
pd
pd
as
xa
hv
hv
"}
(31,1,1) = {"
xa
AA
AA
AA
AA
AA
va
AA
va
va
AA
as
pd
pd
pd
va
pd
pd
pd
pd
pd
as
va
va
as
pd
pd
pd
NJ
NJ
va
NJ
pd
pd
pd
as
pd
pd
pd
pd
pd
as
as
as
pd
pd
pd
as
pd
pd
pd
as
xa
hv
hv
"}
(32,1,1) = {"
xa
AA
va
va
va
AA
va
AA
AA
va
AA
as
pd
pd
pd
va
pd
pd
pd
pd
pd
pd
pd
pd
as
as
va
as
as
pd
pd
pd
pd
pd
pd
as
pd
pd
pd
pd
as
as
pd
pd
pd
pd
pd
as
as
pd
pd
as
xa
hv
hv
"}
(33,1,1) = {"
xa
AA
va
AA
va
va
va
va
va
va
AA
as
as
as
as
as
pd
pd
pd
pd
pd
pd
pd
pd
va
pd
pd
pd
as
pd
pd
pd
pd
pd
pd
as
pd
pd
pd
pd
as
pd
pd
pd
pd
pd
pd
pd
as
pd
pd
as
xa
hv
hv
"}
(34,1,1) = {"
xa
AA
va
AA
AA
AA
AA
AA
AA
va
AA
as
pd
pd
pd
va
pd
pd
pd
pd
pd
pd
pd
pd
va
pd
pd
pd
as
pd
pd
pd
pd
pd
pd
as
va
va
va
as
as
Zp
Zp
as
pd
pd
pd
pd
as
pd
pd
as
xa
hv
hv
"}
(35,1,1) = {"
xa
AA
va
va
va
va
AA
va
va
va
AA
as
pd
pd
pd
va
pd
pd
pd
pd
pd
pd
pd
pd
va
pd
pd
pd
as
as
as
as
as
as
as
as
pd
pd
pd
pd
pd
pd
pd
as
Oh
Tb
Oh
as
as
as
as
as
xa
hv
hv
"}
(36,1,1) = {"
xa
AA
va
AA
AA
va
AA
va
AA
AA
AA
as
pd
pd
pd
va
pd
pd
pd
pd
pd
pd
pd
pd
as
as
va
as
as
pd
pd
pd
pd
pd
pd
Ki
pd
pd
pd
pd
pd
pd
as
as
pd
pd
pd
pd
pd
pd
pd
as
xa
hv
hv
"}
(37,1,1) = {"
xa
AA
va
va
AA
va
va
va
AA
as
as
as
as
as
as
as
va
va
va
va
as
as
as
as
as
pd
pd
pd
pd
pd
pd
pd
pd
pd
pd
as
pd
pd
pd
pd
as
as
as
pd
pd
pd
pd
pd
pd
pd
pd
as
xa
hv
hv
"}
(38,1,1) = {"
xa
AA
AA
va
AA
AA
Xq
AA
AA
as
pd
pd
pd
pd
pd
pd
pd
pd
pd
pd
pd
pd
va
pd
pd
pd
pd
pd
pd
pd
pd
pd
pd
pd
pd
as
as
as
as
as
as
pd
pd
pd
pd
pd
pd
pd
pd
pd
pd
as
xa
hv
hv
"}
(39,1,1) = {"
xa
xa
AA
va
va
va
va
AA
xa
as
pd
pd
pd
pd
pd
pd
pd
pd
pd
pd
pd
pd
va
pd
pd
pd
pd
pd
pd
pd
pd
pd
pd
pd
pd
pd
va
pd
pd
pd
as
pd
pd
pd
pd
pd
pd
pd
pd
pd
pd
as
xa
hv
hv
"}
(40,1,1) = {"
hv
xa
AA
AA
AA
AA
va
AA
xa
as
pd
pd
pd
pd
pd
pd
pd
pd
pd
pd
pd
pd
va
pd
pd
pd
pd
pd
pd
pd
pd
pd
pd
pd
pd
pd
va
pd
pd
pd
as
pd
pd
pd
pd
pd
pd
pd
pd
pd
pd
as
xa
hv
hv
"}
(41,1,1) = {"
hv
xa
xa
AA
va
va
va
AA
xa
as
pd
pd
pd
pd
pd
pd
pd
pd
pd
pd
pd
pd
va
pd
pd
pd
pd
pd
pd
pd
pd
pd
pd
pd
pd
pd
va
pd
pd
pd
as
as
as
as
as
as
as
as
as
as
as
as
xa
hv
hv
"}
(42,1,1) = {"
xa
xa
xa
AA
AA
AA
GT
AA
AA
as
pd
pd
pd
pd
pd
pd
pd
pd
pd
pd
pd
pd
va
pd
pd
pd
pd
pd
pd
pd
pd
pd
va
va
pd
va
va
va
va
va
as
xa
xa
xa
xa
xa
xa
xa
xa
xa
xa
xa
xa
hv
hv
"}
(43,1,1) = {"
xa
as
as
as
as
AA
va
va
AA
as
pd
pd
pd
pd
pd
pd
pd
pd
pd
pd
pd
pd
va
pd
pd
pd
pd
pd
pd
pd
pd
pd
va
pd
pd
pd
va
pd
pd
pd
as
xa
hv
hv
hv
hv
hv
hv
hv
hv
hv
hv
hv
hv
hv
"}
(44,1,1) = {"
xa
as
va
va
as
AA
AA
va
AA
as
pd
pd
pd
pd
pd
pd
pd
pd
pd
pd
pd
pd
as
pd
pd
pd
pd
pd
pd
pd
pd
pd
va
pd
pd
pd
va
pd
pd
pd
as
xa
hv
hv
hv
hv
hv
hv
hv
hv
hv
hv
hv
hv
hv
"}
(45,1,1) = {"
xa
as
va
va
Wn
GT
va
va
AA
as
pd
pd
pd
pd
pd
pd
pd
pd
va
va
va
va
as
pd
pd
pd
pd
pd
pd
pd
pd
pd
va
pd
pd
pd
va
pd
pd
pd
as
xa
hv
hv
hv
hv
hv
hv
hv
hv
hv
hv
hv
hv
hv
"}
(46,1,1) = {"
xa
Lh
va
va
as
AA
va
va
AA
as
pd
pd
pd
pd
pd
pd
pd
pd
va
pd
pd
pd
as
va
va
va
va
pd
pd
pd
pd
pd
va
pd
pd
pd
va
pd
pd
pd
as
xa
hv
hv
hv
hv
hv
hv
hv
hv
hv
hv
hv
hv
hv
"}
(47,1,1) = {"
xa
as
as
as
as
AA
AA
AA
AA
as
pd
pd
pd
pd
pd
pd
pd
pd
va
pd
pd
pd
as
pd
pd
pd
va
pd
pd
pd
pd
pd
va
pd
pd
pd
va
pd
pd
pd
as
xa
hv
hv
hv
hv
hv
hv
hv
hv
hv
hv
hv
hv
hv
"}
(48,1,1) = {"
xa
xa
xa
xa
xa
xa
xa
xa
xa
as
pd
pd
pd
pd
pd
pd
pd
pd
va
pd
pd
pd
as
pd
pd
pd
va
pd
pd
pd
pd
pd
va
pd
pd
pd
va
pd
pd
pd
as
xa
hv
hv
hv
hv
hv
hv
hv
hv
hv
hv
hv
hv
hv
"}
(49,1,1) = {"
hv
hv
hv
hv
hv
hv
hv
hv
xa
as
as
as
as
as
as
as
as
as
as
as
as
as
as
pd
pd
pd
va
pd
pd
pd
pd
pd
va
pd
pd
pd
va
pd
pd
pd
as
xa
hv
hv
hv
hv
hv
hv
hv
hv
hv
hv
hv
hv
hv
"}
(50,1,1) = {"
hv
hv
hv
hv
hv
hv
hv
hv
xa
xa
xa
xa
xa
xa
xa
xa
xa
xa
as
WD
WD
WD
as
pd
pd
pd
va
pd
pd
pd
pd
pd
va
pd
pd
pd
va
pd
pd
pd
as
xa
hv
hv
hv
hv
hv
hv
hv
hv
hv
hv
hv
hv
hv
"}
(51,1,1) = {"
hv
hv
hv
hv
hv
hv
hv
hv
hv
hv
hv
hv
hv
hv
hv
hv
hv
xa
as
WD
WD
WD
as
as
as
as
as
as
Ft
Ft
Ft
as
as
as
as
as
as
as
as
as
as
xa
hv
hv
hv
hv
hv
hv
hv
hv
hv
hv
hv
hv
hv
"}
(52,1,1) = {"
hv
hv
hv
hv
hv
hv
hv
hv
hv
hv
hv
hv
hv
hv
hv
hv
hv
xa
as
as
as
Vr
as
xa
xa
xa
xa
as
dL
dL
dL
as
xa
xa
xa
xa
xa
xa
xa
xa
xa
xa
hv
hv
hv
hv
hv
hv
hv
hv
hv
hv
hv
hv
hv
"}
(53,1,1) = {"
hv
hv
hv
hv
hv
hv
hv
hv
hv
hv
hv
hv
hv
hv
hv
hv
hv
xa
xa
xa
xa
xa
xa
xa
hv
hv
xa
as
dL
dL
dL
as
xa
hv
hv
hv
hv
hv
hv
hv
hv
hv
hv
hv
hv
hv
hv
hv
hv
hv
hv
hv
hv
hv
hv
"}
(54,1,1) = {"
hv
hv
hv
hv
hv
hv
hv
hv
hv
hv
hv
hv
hv
hv
hv
hv
hv
hv
hv
hv
hv
hv
hv
hv
hv
hv
xa
as
as
as
as
as
xa
hv
hv
hv
hv
hv
hv
hv
hv
hv
hv
hv
hv
hv
hv
hv
hv
hv
hv
hv
hv
hv
hv
"}
(55,1,1) = {"
hv
hv
hv
hv
hv
hv
hv
hv
hv
hv
hv
hv
hv
hv
hv
hv
hv
hv
hv
hv
hv
hv
hv
hv
hv
hv
xa
xa
xa
xa
xa
xa
xa
hv
hv
hv
hv
hv
hv
hv
hv
hv
hv
hv
hv
hv
hv
hv
hv
hv
hv
hv
hv
hv
hv
"}
