//MAP CONVERTED BY dmm2tgm.py THIS HEADER COMMENT PREVENTS RECONVERSION, DO NOT REMOVE
"aa" = (
/turf/closed/mineral/random/stationside/asteroid/porus,
/area/station/asteroid)
"ab" = (
/obj/effect/decal/cleanable/dirt,
/obj/machinery/atmospherics/pipe/smart/manifold4w/scrubbers/hidden/layer2,
/obj/machinery/atmospherics/pipe/smart/manifold4w/supply/hidden/layer4,
/obj/structure/cable,
/turf/open/floor/catwalk_floor,
/area/station/maintenance/starboard/greater)
"ac" = (
/obj/effect/decal/cleanable/dirt,
/obj/structure/cable/multilayer/connected,
/turf/open/floor/catwalk_floor,
/area/station/maintenance/starboard/greater)
"ad" = (
/obj/machinery/atmospherics/pipe/smart/manifold4w/supply/hidden/layer4,
/obj/effect/decal/cleanable/dirt,
/obj/structure/cable,
/turf/open/floor/catwalk_floor,
/area/station/maintenance/starboard/greater)
"ae" = (
/obj/item/mop{
	pixel_x = -1;
	pixel_y = -30
	},
/turf/closed/wall,
/area/station/maintenance/starboard/greater)
"af" = (
/obj/effect/decal/cleanable/dirt,
/obj/structure/girder,
/obj/structure/grille,
/turf/open/floor/iron/smooth,
/area/station/maintenance/starboard/greater)
"ag" = (
/obj/effect/turf_decal/stripes/white/line{
	dir = 1
	},
/obj/effect/decal/cleanable/dirt,
/turf/open/floor/plating,
/area/station/maintenance/starboard/greater)
"ah" = (
/obj/structure/cable,
/obj/machinery/atmospherics/pipe/smart/manifold4w/supply/hidden/layer4,
/obj/machinery/atmospherics/pipe/smart/manifold4w/scrubbers/hidden/layer2,
/obj/structure/railing{
	dir = 4
	},
/obj/structure/railing{
	dir = 8
	},
/obj/effect/decal/cleanable/dirt,
/turf/open/floor/iron/stairs/old,
/area/station/maintenance/starboard/greater)
"ai" = (
/obj/structure/cable,
/obj/machinery/atmospherics/pipe/smart/manifold4w/supply/hidden/layer4,
/obj/machinery/atmospherics/pipe/smart/manifold4w/scrubbers/hidden/layer2,
/obj/structure/ladder,
/obj/machinery/light/small/directional/north,
/obj/effect/decal/cleanable/dirt,
/turf/open/floor/catwalk_floor,
/area/station/maintenance/starboard/greater)
"aj" = (
/obj/effect/decal/cleanable/dirt,
/turf/open/floor/iron/smooth,
/area/station/maintenance/starboard/greater)
"ak" = (
/obj/machinery/atmospherics/pipe/smart/manifold4w/supply/hidden/layer4,
/obj/structure/cable,
/obj/machinery/atmospherics/pipe/smart/manifold4w/scrubbers/hidden/layer2,
/obj/effect/decal/cleanable/dirt,
/turf/open/floor/catwalk_floor,
/area/station/maintenance/starboard/greater)
"al" = (
/obj/structure/railing,
/obj/effect/turf_decal/siding/wideplating/dark,
/obj/effect/decal/cleanable/dirt,
/turf/open/floor/iron/smooth,
/area/station/maintenance/starboard/greater)
"am" = (
/obj/item/stack/cable_coil,
/turf/open/misc/asteroid/airless,
/area/station/asteroid)
"an" = (
/obj/effect/decal/cleanable/dirt,
/obj/machinery/door/airlock/maintenance_hatch{
	name = "Custodial Maintenance Hatch"
	},
/obj/effect/mapping_helpers/airlock/access/all/engineering/maintenance,
/turf/open/floor/plating,
/area/station/maintenance/starboard/greater)
"ao" = (
/obj/item/assembly/mousetrap/armed,
/obj/structure/railing,
/obj/effect/turf_decal/siding/wideplating/dark,
/obj/effect/decal/cleanable/dirt,
/turf/open/floor/iron/smooth,
/area/station/maintenance/starboard/greater)
"ap" = (
/obj/machinery/door/airlock/external{
	name = "External Access"
	},
/obj/effect/mapping_helpers/airlock/cyclelink_helper{
	dir = 1
	},
/obj/machinery/atmospherics/pipe/smart/manifold4w/supply/hidden/layer4,
/obj/effect/decal/cleanable/dirt,
/obj/structure/cable,
/obj/effect/mapping_helpers/airlock/access/all/engineering/external,
/turf/open/floor/catwalk_floor,
/area/station/maintenance/starboard/greater)
"aq" = (
/obj/effect/decal/cleanable/dirt,
/obj/structure/closet,
/obj/effect/spawner/random/decoration/paint,
/obj/effect/spawner/random/engineering/material_cheap,
/obj/effect/spawner/random/clothing/costume,
/obj/effect/spawner/random/clothing/gloves,
/turf/open/floor/plating,
/area/station/maintenance/starboard/greater)
"ar" = (
/obj/effect/decal/cleanable/dirt,
/obj/structure/sign/warning/vacuum/external,
/turf/open/floor/iron/smooth,
/area/station/maintenance/starboard/greater)
"as" = (
/obj/effect/turf_decal/stripes/end,
/obj/machinery/atmospherics/pipe/multiz/scrubbers/hidden/layer2{
	dir = 4
	},
/obj/machinery/atmospherics/pipe/multiz/supply/hidden/layer4{
	dir = 4
	},
/obj/effect/decal/cleanable/dirt,
/turf/open/floor/plating,
/area/station/maintenance/starboard/greater)
"at" = (
/obj/effect/turf_decal/sand/plating,
/obj/structure/cable/layer1,
/turf/open/floor/plating/airless,
/area/station/asteroid)
"au" = (
/obj/effect/decal/cleanable/dirt,
/obj/structure/rack,
/obj/effect/spawner/random/maintenance/three,
/obj/effect/spawner/random/engineering/material_cheap,
/turf/open/floor/iron/smooth,
/area/station/maintenance/starboard/greater)
"av" = (
/obj/effect/decal/cleanable/dirt,
/obj/effect/decal/cleanable/cobweb/cobweb2{
	pixel_y = 24
	},
/obj/effect/spawner/random/engineering/canister,
/turf/open/floor/iron/smooth,
/area/station/maintenance/starboard/greater)
"aw" = (
/obj/machinery/door/airlock/external{
	name = "External Access"
	},
/obj/effect/mapping_helpers/airlock/cyclelink_helper,
/obj/effect/decal/cleanable/dirt,
/obj/structure/cable/layer1,
/obj/effect/mapping_helpers/airlock/access/all/engineering/external,
/turf/open/floor/catwalk_floor,
/area/station/maintenance/starboard/greater)
"ax" = (
/obj/structure/cable,
/obj/machinery/atmospherics/pipe/smart/manifold4w/supply/hidden/layer4,
/obj/machinery/atmospherics/pipe/smart/manifold4w/scrubbers/hidden/layer2,
/obj/structure/railing/corner,
/obj/structure/railing/corner{
	dir = 8
	},
/obj/effect/decal/cleanable/dirt,
/turf/open/floor/catwalk_floor,
/area/station/maintenance/starboard/greater)
"ay" = (
/obj/modular_map_connector,
/turf/template_noop,
/area/template_noop)
"az" = (
/obj/effect/decal/cleanable/dirt,
/obj/structure/table,
/obj/item/soap,
/turf/open/floor/iron/smooth,
/area/station/maintenance/starboard/greater)
"aA" = (
/obj/structure/cable,
/obj/effect/decal/cleanable/dirt,
/obj/machinery/atmospherics/pipe/smart/manifold4w/supply/hidden/layer4,
/obj/machinery/atmospherics/pipe/smart/manifold4w/scrubbers/hidden/layer2,
/turf/open/floor/catwalk_floor,
/area/station/maintenance/starboard/greater)
"aB" = (
/obj/effect/decal/cleanable/dirt,
/obj/machinery/light/small/directional/west,
/turf/open/floor/iron/smooth,
/area/station/maintenance/starboard/greater)
"aC" = (
/obj/effect/decal/cleanable/dirt,
/obj/structure/cable,
/turf/open/floor/catwalk_floor,
/area/station/maintenance/starboard/greater)
"aD" = (
/obj/effect/decal/cleanable/dirt,
/turf/open/floor/plating,
/area/station/maintenance/starboard/greater)
"aE" = (
/obj/effect/decal/cleanable/dirt,
/obj/machinery/atmospherics/pipe/smart/manifold4w/supply/hidden/layer4,
/obj/machinery/atmospherics/pipe/smart/manifold4w/scrubbers/hidden/layer2,
/obj/structure/cable,
/turf/open/floor/catwalk_floor,
/area/station/maintenance/starboard/greater)
"aF" = (
/obj/effect/decal/cleanable/dirt,
/obj/effect/spawner/random/engineering/atmospherics_portable,
/turf/open/floor/iron/smooth,
/area/station/maintenance/starboard/greater)
"aG" = (
/obj/effect/decal/cleanable/dirt,
/obj/structure/mirror/directional/north,
/obj/item/reagent_containers/cup/bucket{
	pixel_x = -10;
	pixel_y = 18
	},
/obj/structure/sink/directional/north,
/turf/open/floor/plating,
/area/station/maintenance/starboard/greater)
"aH" = (
/obj/effect/decal/cleanable/dirt,
/obj/structure/grille,
/turf/open/floor/iron/smooth,
/area/station/maintenance/starboard/greater)
"aI" = (
/obj/effect/decal/cleanable/dirt,
/obj/effect/decal/cleanable/cobweb/cobweb2,
/turf/open/floor/iron/smooth,
/area/station/maintenance/starboard/greater)
"aJ" = (
/turf/open/misc/asteroid/airless,
/area/station/asteroid)
"aK" = (
/turf/closed/wall,
/area/station/maintenance/starboard/greater)
"aL" = (
/obj/effect/decal/cleanable/dirt,
/obj/structure/closet/crate,
/obj/effect/spawner/random/maintenance/four,
/obj/effect/spawner/random/engineering/tool,
/turf/open/floor/iron/smooth,
/area/station/maintenance/starboard/greater)
"aM" = (
/obj/machinery/atmospherics/components/unary/vent_pump/on/layer4{
	dir = 4
	},
/obj/effect/decal/cleanable/dirt,
/turf/open/floor/iron/smooth,
/area/station/maintenance/starboard/greater)
"aN" = (
/obj/effect/decal/cleanable/dirt,
/obj/machinery/atmospherics/pipe/smart/manifold4w/supply/hidden/layer4,
/obj/structure/cable,
/turf/open/floor/catwalk_floor,
/area/station/maintenance/starboard/greater)
"aO" = (
/obj/structure/cable/multilayer/multiz,
/obj/effect/turf_decal/stripes/end,
/obj/effect/decal/cleanable/dirt,
/obj/structure/sign/warning/electric_shock,
/turf/open/floor/plating,
/area/station/maintenance/starboard/greater)
"aP" = (
/obj/effect/decal/cleanable/dirt,
/obj/effect/decal/cleanable/cobweb/cobweb2{
	pixel_y = 24
	},
/turf/open/floor/iron/smooth,
/area/station/maintenance/starboard/greater)
"aQ" = (
/obj/effect/decal/cleanable/dirt,
/obj/effect/decal/cleanable/cobweb/cobweb2{
	pixel_y = 24
	},
/obj/effect/spawner/random/structure/steam_vent,
/turf/open/floor/iron/smooth,
/area/station/maintenance/starboard/greater)
"aR" = (
/obj/modular_map_root/tramstation{
	key = "servicecargolower_attachment_b";
	name = "servicecargolower_attachment_b"
	},
/turf/open/floor/plating,
/area/station/maintenance/starboard/greater)
"aS" = (
/obj/effect/decal/cleanable/dirt,
/obj/machinery/door/airlock/maintenance_hatch{
	name = "Maintenance Hatch"
	},
/obj/effect/mapping_helpers/airlock/access/all/engineering/maintenance,
/turf/open/floor/iron/smooth,
/area/station/maintenance/starboard/greater)
"aT" = (
/obj/modular_map_root/tramstation{
	key = "servicecargolower_attachment_a";
	name = "servicecargolower_attachment_a"
	},
/turf/open/floor/plating,
/area/station/maintenance/starboard/greater)
"aU" = (
/obj/effect/decal/cleanable/dirt,
/obj/effect/spawner/random/clothing/wardrobe_closet,
/turf/open/floor/plating,
/area/station/maintenance/starboard/greater)
"aV" = (
/obj/effect/decal/cleanable/dirt,
/obj/structure/reagent_dispensers/watertank,
/turf/open/floor/iron/smooth,
/area/station/maintenance/starboard/greater)
"aW" = (
/obj/effect/turf_decal/sand/plating,
/turf/open/floor/plating/airless,
/area/station/asteroid)
"aX" = (
/obj/effect/decal/cleanable/dirt,
/obj/structure/cable/layer1,
/turf/open/floor/catwalk_floor,
/area/station/maintenance/starboard/greater)
"aY" = (
/obj/effect/decal/cleanable/dirt,
/obj/machinery/power/apc/auto_name/directional/south,
/obj/structure/cable,
/turf/open/floor/catwalk_floor,
/area/station/maintenance/starboard/greater)
"aZ" = (
/turf/template_noop,
/area/template_noop)
"cJ" = (
/obj/structure/cable/multilayer/multiz,
/obj/effect/turf_decal/stripes/end,
/obj/structure/sign/warning/electric_shock/directional/north,
/obj/effect/decal/cleanable/dirt,
/turf/open/floor/plating,
/area/station/maintenance/starboard/greater)
"dP" = (
/obj/effect/decal/cleanable/dirt,
/obj/structure/sign/warning/vacuum/external/directional/north,
/turf/open/floor/iron/smooth,
/area/station/maintenance/starboard/greater)
"AY" = (
/obj/effect/decal/cleanable/dirt,
/obj/structure/sink{
	pixel_y = 15
	},
/obj/structure/mirror/directional/north,
/obj/item/reagent_containers/cup/bucket{
	pixel_x = -10;
	pixel_y = 18
	},
/turf/open/floor/plating,
/area/station/maintenance/starboard/greater)
"Ll" = (
/obj/effect/decal/cleanable/dirt,
/obj/effect/decal/cleanable/cobweb/cobweb2,
/obj/effect/spawner/random/engineering/canister,
/turf/open/floor/iron/smooth,
/area/station/maintenance/starboard/greater)
"Ue" = (
/obj/effect/decal/cleanable/dirt,
/obj/effect/decal/cleanable/cobweb/cobweb2,
/obj/effect/spawner/random/structure/steam_vent,
/turf/open/floor/iron/smooth,
/area/station/maintenance/starboard/greater)

(1,1,1) = {"
aZ
aZ
aZ
aZ
aZ
aZ
aZ
aZ
ay
aZ
aZ
aZ
aZ
aZ
aZ
aZ
aZ
aZ
aZ
aZ
aZ
aZ
aZ
aZ
"}
(2,1,1) = {"
aZ
aZ
aZ
aZ
aZ
aZ
aZ
aj
aA
aK
aZ
aZ
aZ
aZ
aZ
aZ
aZ
aZ
aZ
aZ
aZ
aZ
aZ
aZ
"}
(3,1,1) = {"
aZ
aZ
aZ
aZ
aZ
aZ
aZ
aj
aA
aK
aZ
aZ
aZ
aZ
aZ
aZ
aZ
aZ
aZ
aZ
aZ
aZ
aZ
aZ
"}
(4,1,1) = {"
aZ
aZ
aZ
aZ
aZ
aZ
aZ
aF
aA
aK
aK
aK
aZ
aZ
aZ
aZ
aZ
aZ
aZ
aZ
aZ
aZ
aZ
aZ
"}
(5,1,1) = {"
aZ
aZ
aZ
aZ
aZ
aZ
aZ
Ll
aA
aA
aA
aA
aZ
aZ
aZ
aZ
aZ
aZ
aZ
aZ
aZ
aZ
aZ
aZ
"}
(6,1,1) = {"
aZ
aa
aa
aa
aa
aa
aK
aK
aK
aK
aK
aA
aZ
aZ
aZ
aZ
aZ
aZ
aZ
aZ
aZ
aZ
aZ
aZ
"}
(7,1,1) = {"
aa
aa
aa
aa
aa
aa
aa
aa
aa
aa
aT
aA
aZ
aZ
aZ
aZ
aZ
aZ
aZ
aZ
aZ
aZ
aZ
aZ
"}
(8,1,1) = {"
aa
aa
aa
aa
aa
aa
aa
aa
aa
aa
aK
aA
aK
aZ
aZ
aZ
aZ
aZ
aZ
aZ
aZ
aZ
aZ
aZ
"}
(9,1,1) = {"
aa
aa
aa
aa
aa
aa
aa
aa
aa
aa
aK
aA
aK
aZ
aZ
aZ
aZ
aZ
aZ
aZ
aZ
aZ
aZ
aZ
"}
(10,1,1) = {"
aa
aa
aa
aa
aa
aa
aa
aa
aa
aa
aK
aA
aK
aZ
aZ
aZ
aZ
aZ
aZ
aZ
aZ
aZ
aZ
aZ
"}
(11,1,1) = {"
aa
aa
aa
aa
aa
aa
aa
aa
aa
aa
aK
aA
aK
aZ
aZ
aZ
aZ
aZ
aZ
aZ
aZ
aZ
aZ
aZ
"}
(12,1,1) = {"
aa
aa
aa
aa
aa
aa
aa
aa
aa
aa
aK
aA
aK
aZ
aZ
aZ
aZ
aZ
aZ
aZ
aZ
aZ
aZ
aZ
"}
(13,1,1) = {"
aa
aa
aa
aa
aa
aa
aa
aa
aa
aa
aK
aA
aK
aK
aZ
aZ
aZ
aZ
aZ
aZ
aZ
aZ
aZ
aZ
"}
(14,1,1) = {"
aa
aa
aa
aa
aa
aa
aa
aa
aa
aa
aK
aA
aL
aK
aZ
aZ
aZ
aZ
aZ
aZ
aZ
aZ
aZ
aZ
"}
(15,1,1) = {"
aa
aa
aa
aa
aa
aa
aa
aa
aa
aa
aK
aA
au
aK
aZ
aZ
aZ
aZ
aZ
aZ
aZ
aZ
aZ
aZ
"}
(16,1,1) = {"
aa
aa
aa
aa
aa
aa
aa
aa
aa
aa
aK
aA
af
aK
aK
aK
aZ
aZ
aZ
aZ
aZ
aZ
aZ
aZ
"}
(17,1,1) = {"
aa
aa
aa
aa
aa
aa
aa
aK
aK
aK
aK
aA
aj
ae
AY
aK
aZ
aZ
aZ
aZ
aZ
aZ
aZ
aZ
"}
(18,1,1) = {"
aa
aa
aa
aa
aa
aa
aa
aK
aj
al
ag
aA
aj
aK
aD
aK
aZ
aZ
aZ
aZ
aZ
aZ
aZ
aZ
"}
(19,1,1) = {"
aa
aa
aa
aa
aa
aa
aa
aK
as
al
ag
aA
aj
aK
an
aK
aK
aZ
aZ
aZ
aZ
aZ
aZ
aZ
"}
(20,1,1) = {"
aa
aa
aa
aa
aa
aa
aa
aK
ai
ax
ah
ak
aY
aK
aj
az
aK
aZ
aZ
aZ
aZ
aZ
aZ
aZ
"}
(21,1,1) = {"
aa
aa
aa
aa
aa
aa
aa
aK
cJ
ao
ag
aA
aj
aK
aj
aV
aK
aZ
aZ
aZ
aZ
aZ
aZ
aZ
"}
(22,1,1) = {"
aa
aa
aa
aa
aa
aa
aa
aK
aj
al
ag
aE
aj
aS
aj
aj
aK
aZ
aZ
aZ
aZ
aZ
aZ
aZ
"}
(23,1,1) = {"
aa
aa
aa
aa
aa
aJ
aK
aK
aK
aK
aK
aE
aj
aK
aK
aK
aK
aZ
aZ
aZ
aZ
aZ
aZ
aZ
"}
(24,1,1) = {"
aa
aa
aa
aa
aJ
aW
aK
aB
aM
aK
aj
aE
aK
aK
aa
aa
aa
aZ
aZ
aZ
aZ
aZ
aZ
aZ
"}
(25,1,1) = {"
aa
aa
aa
aJ
aJ
at
aw
aX
ad
ap
aN
ab
aK
aa
aa
aa
aa
aZ
aZ
aZ
aZ
aZ
aZ
aZ
"}
(26,1,1) = {"
aa
aa
aa
aJ
aJ
at
aK
ac
aC
aK
dP
ab
aK
aa
aa
aa
aa
aZ
aZ
aZ
aZ
aZ
aZ
aZ
"}
(27,1,1) = {"
aa
aa
aa
aJ
at
at
aK
aK
aK
aK
aj
ab
aK
aa
aa
aa
aa
aZ
aZ
aZ
aZ
aZ
aZ
aZ
"}
(28,1,1) = {"
aa
aJ
aJ
aJ
at
aJ
aJ
aJ
aJ
aK
Ue
ab
aK
aa
aa
aa
aa
aZ
aZ
aZ
aZ
aZ
aZ
aZ
"}
(29,1,1) = {"
am
at
at
at
at
aJ
aJ
aJ
aJ
aK
aK
ab
aK
aa
aa
aa
aa
aZ
aZ
aZ
aZ
aZ
aZ
aZ
"}
(30,1,1) = {"
aJ
at
aJ
aJ
aJ
aa
aa
aJ
aJ
aJ
aK
ab
aK
aa
aa
aa
aa
aZ
aZ
aZ
aZ
aZ
aZ
aZ
"}
(31,1,1) = {"
at
at
aJ
aJ
aa
aa
aa
aJ
aa
aJ
aK
ab
aR
aa
aa
aa
aa
aZ
aZ
aZ
aZ
aZ
aZ
aZ
"}
(32,1,1) = {"
aJ
aJ
aa
aJ
aa
aa
aa
aa
aa
aJ
aK
ab
aK
aa
aa
aa
aa
aZ
aZ
aZ
aZ
aZ
aZ
aZ
"}
(33,1,1) = {"
aa
aa
aa
aa
aa
aa
aa
aa
aa
aa
aK
ab
aK
aa
aa
aa
aa
aZ
aZ
aZ
aZ
aZ
aZ
aZ
"}
(34,1,1) = {"
aa
aa
aa
aZ
aZ
aZ
aZ
aZ
aa
aa
aK
ab
aZ
aZ
aZ
aZ
aZ
aZ
aZ
aa
aa
aZ
aZ
aZ
"}
(35,1,1) = {"
aa
aa
aa
aZ
aZ
aZ
aZ
aZ
aa
aa
aK
ab
aZ
aZ
aZ
aZ
aZ
aZ
aZ
aa
aa
aZ
aZ
aZ
"}
(36,1,1) = {"
aa
aa
aa
aZ
aZ
aZ
aZ
aZ
aa
aa
aK
ab
aZ
aZ
aZ
aZ
aZ
aZ
aZ
aa
aa
aZ
aZ
aZ
"}
(37,1,1) = {"
aZ
aZ
aZ
aZ
aZ
aZ
aZ
aZ
aZ
aZ
aZ
ab
aZ
aZ
aZ
aZ
aZ
aZ
aZ
aa
aa
aZ
aZ
aZ
"}
(38,1,1) = {"
aZ
aZ
aZ
aZ
aZ
aZ
aZ
aZ
aZ
aZ
aZ
ab
aZ
aZ
aZ
aZ
aZ
aZ
aZ
aa
aa
aa
aZ
aZ
"}
(39,1,1) = {"
aZ
aZ
aZ
aZ
aZ
aZ
aZ
aZ
aZ
aZ
aZ
ab
aZ
aZ
aZ
aZ
aZ
aZ
aZ
aK
aK
aK
aa
aZ
"}
(40,1,1) = {"
aZ
aZ
aZ
aZ
aZ
aZ
aZ
aZ
aZ
aZ
aZ
ab
ab
ab
aZ
aZ
aZ
aZ
aZ
aU
aq
aK
aa
aZ
"}
(41,1,1) = {"
aZ
aZ
aZ
aZ
aZ
aZ
aZ
aZ
aZ
aZ
aZ
aZ
aZ
ab
aZ
aZ
aZ
aZ
aZ
aH
aH
aK
aa
aZ
"}
(42,1,1) = {"
aZ
aZ
aZ
aZ
aZ
aZ
aZ
aZ
aZ
aZ
aZ
aZ
aZ
ab
ab
aj
aj
aj
aj
aj
aj
aK
aK
aZ
"}
(43,1,1) = {"
aZ
aZ
aZ
aZ
aZ
aZ
aZ
aZ
aZ
aZ
aZ
aZ
aZ
aZ
ab
aZ
aZ
aZ
aZ
aZ
aI
aj
aj
aZ
"}
(44,1,1) = {"
aZ
aZ
aZ
aZ
aZ
aZ
aZ
aZ
aZ
aZ
aZ
aZ
aZ
aZ
aZ
aZ
aZ
aZ
aZ
aZ
aZ
aZ
aZ
aZ
"}
