//MAP CONVERTED BY dmm2tgm.py THIS HEADER COMMENT PREVENTS RECONVERSION, DO NOT REMOVE
"aa" = (
/turf/template_noop,
/area/template_noop)
"ab" = (
/turf/closed/mineral/volcanic/lava_land_surface,
/area/lavaland/surface)
"ac" = (
/turf/closed/mineral/volcanic/lava_land_surface,
/area/ruin/unpowered/elephant_graveyard)
"at" = (
/turf/closed/mineral/strong/wasteland,
/area/lavaland/surface)
"aA" = (
/turf/closed/wall,
/area/ruin/unpowered/elephant_graveyard)
"aH" = (
/turf/closed/wall/mineral/titanium,
/area/ruin/powered/graveyard_shuttle)
"aN" = (
/turf/closed/wall/mineral/titanium/nodiagonal,
/area/ruin/powered/graveyard_shuttle)
"aO" = (
/obj/effect/decal/cleanable/glass,
/obj/machinery/computer,
/turf/open/floor/mineral/titanium/white,
/area/ruin/powered/graveyard_shuttle)
"bf" = (
/turf/closed/mineral/strong/wasteland,
/area/ruin/unpowered/elephant_graveyard)
"bh" = (
/obj/effect/decal/cleanable/oil,
/obj/structure/chair/office/light,
/turf/open/floor/mineral/titanium/white,
/area/ruin/powered/graveyard_shuttle)
"bi" = (
/obj/effect/turf_decal/delivery/white,
/turf/open/floor/circuit/off,
/area/ruin/powered/graveyard_shuttle)
"bp" = (
/turf/open/floor/mineral/titanium/white,
/area/ruin/powered/graveyard_shuttle)
"bq" = (
/obj/machinery/iv_drip,
/turf/open/floor/mineral/titanium/white,
/area/ruin/powered/graveyard_shuttle)
"bS" = (
/obj/effect/decal/cleanable/oil/slippery,
/obj/machinery/rnd/destructive_analyzer,
/turf/open/floor/mineral/titanium/white,
/area/ruin/powered/graveyard_shuttle)
"bX" = (
/obj/structure/table,
/obj/item/taperecorder,
/turf/open/misc/asteroid/basalt/wasteland,
/area/ruin/unpowered/elephant_graveyard)
"cH" = (
/obj/machinery/power/floodlight,
/obj/structure/cable,
/turf/open/misc/asteroid/basalt/wasteland,
/area/ruin/unpowered/elephant_graveyard)
"cZ" = (
/obj/structure/stone_tile{
	dir = 8
	},
/turf/open/misc/asteroid/basalt/wasteland,
/area/ruin/unpowered/elephant_graveyard)
"do" = (
/obj/structure/stone_tile/block/cracked,
/turf/open/misc/asteroid/basalt/wasteland,
/area/ruin/unpowered/elephant_graveyard)
"dr" = (
/obj/effect/decal/cleanable/dirt,
/turf/open/misc/asteroid/basalt/wasteland,
/area/ruin/unpowered/elephant_graveyard)
"ek" = (
/obj/structure/table,
/obj/item/tape/random,
/obj/item/tape/random,
/turf/open/misc/asteroid/basalt/wasteland,
/area/ruin/unpowered/elephant_graveyard)
"eu" = (
/obj/effect/decal/cleanable/blood/old,
/turf/open/misc/asteroid/basalt/wasteland,
/area/ruin/unpowered/elephant_graveyard)
"eJ" = (
/obj/structure/cable,
/obj/item/reagent_containers/cup/bottle/frostoil{
	desc = "A small bottle. Contains cold sauce. There's a label on here: APPLY ON SEVERE BURNS.";
	volume = 10
	},
/turf/open/misc/asteroid/basalt/wasteland,
/area/ruin/unpowered/elephant_graveyard)
"eM" = (
/obj/structure/cable,
/obj/machinery/power/floodlight,
/turf/open/misc/asteroid/basalt/wasteland,
/area/ruin/unpowered/elephant_graveyard)
"gl" = (
/obj/effect/decal/remains/human,
/obj/effect/decal/cleanable/blood/old,
/obj/effect/decal/cleanable/shreds,
/turf/open/misc/asteroid/basalt/wasteland,
/area/ruin/unpowered/elephant_graveyard)
"gu" = (
/obj/structure/ore_box,
/turf/open/misc/asteroid/basalt/wasteland,
/area/ruin/unpowered/elephant_graveyard)
"gB" = (
/turf/open/misc/asteroid/basalt/wasteland,
/area/ruin/unpowered/elephant_graveyard)
"gM" = (
/obj/structure/sign/warning/secure_area,
/turf/closed/wall/mineral/titanium,
/area/ruin/powered/graveyard_shuttle)
"iE" = (
/obj/structure/barricade/wooden/crude,
/obj/item/paper/fluff/ruins/elephant_graveyard,
/turf/open/misc/asteroid/basalt/lava_land_surface,
/area/ruin/unpowered/elephant_graveyard)
"iR" = (
/obj/structure/statue/bone/skull/half{
	dir = 1
	},
/turf/open/misc/asteroid/basalt/wasteland,
/area/ruin/unpowered/elephant_graveyard)
"jx" = (
/obj/machinery/power/shuttle_engine/propulsion,
/turf/open/misc/asteroid/basalt/lava_land_surface,
/area/ruin/powered/graveyard_shuttle)
"jI" = (
/obj/structure/sign/warning/xeno_mining,
/turf/closed/wall,
/area/ruin/unpowered/elephant_graveyard)
"jK" = (
/obj/effect/decal/cleanable/blood/tracks{
	dir = 4
	},
/turf/open/misc/asteroid/basalt/wasteland,
/area/ruin/unpowered/elephant_graveyard)
"kk" = (
/obj/structure/stone_tile,
/turf/open/misc/asteroid/basalt/wasteland,
/area/ruin/unpowered/elephant_graveyard)
"km" = (
/obj/structure/headpike/bone,
/turf/open/misc/asteroid/basalt/wasteland,
/area/ruin/unpowered/elephant_graveyard)
"li" = (
/obj/effect/decal/remains/human,
/obj/item/tank/internals/emergency_oxygen/empty,
/obj/effect/decal/cleanable/blood/old,
/turf/open/misc/asteroid/basalt/wasteland,
/area/ruin/unpowered/elephant_graveyard)
"mH" = (
/obj/structure/table,
/obj/effect/spawner/random/decoration/glowstick,
/turf/open/misc/asteroid/basalt/wasteland,
/area/ruin/unpowered/elephant_graveyard)
"nv" = (
/obj/structure/reagent_dispensers/water_cooler,
/turf/open/misc/asteroid/basalt/wasteland,
/area/ruin/unpowered/elephant_graveyard)
"nA" = (
/obj/structure/stone_tile/block/cracked{
	dir = 4
	},
/turf/open/misc/asteroid/basalt/wasteland,
/area/ruin/unpowered/elephant_graveyard)
"ov" = (
/obj/effect/decal/cleanable/blood/drip,
/obj/structure/stone_tile/cracked,
/turf/open/misc/asteroid/basalt/wasteland,
/area/ruin/unpowered/elephant_graveyard)
"oA" = (
/obj/effect/decal/remains/human,
/obj/effect/decal/cleanable/dirt,
/obj/item/clothing/head/fedora/curator,
/obj/item/clothing/suit/jacket/curator,
/turf/open/floor/mineral/titanium/white,
/area/ruin/powered/graveyard_shuttle)
"oK" = (
/obj/effect/decal/remains/human,
/turf/open/misc/asteroid/basalt/wasteland,
/area/ruin/unpowered/elephant_graveyard)
"oL" = (
/obj/structure/bonfire/prelit,
/obj/effect/decal/cleanable/ash,
/obj/item/organ/external/tail/lizard,
/obj/effect/decal/cleanable/blood/old,
/obj/structure/stone_tile/slab/cracked,
/turf/open/misc/asteroid/basalt/wasteland,
/area/ruin/unpowered/elephant_graveyard)
"pB" = (
/obj/structure/table,
/obj/item/storage/medkit/o2,
/turf/open/misc/asteroid/basalt/wasteland,
/area/ruin/unpowered/elephant_graveyard)
"qy" = (
/obj/item/organ/internal/brain,
/turf/open/misc/asteroid/basalt/wasteland,
/area/ruin/unpowered/elephant_graveyard)
"qA" = (
/obj/item/knife/combat/bone,
/obj/item/organ/internal/tongue,
/obj/effect/decal/cleanable/blood/old,
/turf/open/misc/asteroid/basalt/wasteland,
/area/ruin/unpowered/elephant_graveyard)
"qT" = (
/obj/structure/table,
/obj/structure/cable,
/obj/item/clipboard,
/turf/open/misc/asteroid/basalt/wasteland,
/area/ruin/unpowered/elephant_graveyard)
"rg" = (
/obj/structure/rack,
/obj/item/shovel,
/obj/structure/cable,
/obj/item/wrench,
/turf/open/misc/asteroid/basalt/wasteland,
/area/ruin/unpowered/elephant_graveyard)
"sl" = (
/obj/structure/filingcabinet/chestdrawer,
/obj/effect/decal/cleanable/cobweb,
/obj/item/paper/fluff/ruins/elephant_graveyard/hypothesis,
/obj/effect/decal/cleanable/dirt,
/turf/open/floor/mineral/titanium/white,
/area/ruin/powered/graveyard_shuttle)
"sV" = (
/obj/structure/sign/poster/ripped,
/turf/closed/wall,
/area/ruin/unpowered/elephant_graveyard)
"tf" = (
/turf/open/misc/asteroid/basalt/wasteland{
	icon_state = "wasteland_dug"
	},
/area/ruin/unpowered/elephant_graveyard)
"uj" = (
/obj/structure/bed,
/obj/item/flashlight/lantern,
/turf/open/misc/asteroid/basalt/wasteland,
/area/ruin/unpowered/elephant_graveyard)
"vk" = (
/obj/structure/closet/crate/grave/filled,
/obj/effect/decal/cleanable/dirt,
/obj/effect/mob_spawn/corpse/human/skeleton,
/turf/open/misc/asteroid/basalt/wasteland,
/area/ruin/unpowered/elephant_graveyard)
"vS" = (
/obj/structure/stone_tile,
/obj/effect/decal/cleanable/dirt,
/turf/open/misc/asteroid/basalt/wasteland,
/area/ruin/unpowered/elephant_graveyard)
"wa" = (
/obj/item/food/deadmouse,
/obj/item/assembly/mousetrap,
/turf/open/misc/asteroid/basalt/wasteland{
	icon_state = "wasteland_dug"
	},
/area/ruin/unpowered/elephant_graveyard)
"xh" = (
/obj/structure/sign/warning/no_smoking/circle,
/turf/closed/wall,
/area/ruin/unpowered/elephant_graveyard)
"xr" = (
/obj/effect/decal/cleanable/vomit,
/obj/item/shovel,
/turf/open/misc/asteroid/basalt/wasteland,
/area/ruin/unpowered/elephant_graveyard)
"xz" = (
/obj/effect/decal/remains/human,
/obj/item/restraints/handcuffs/cable/zipties/used,
/turf/open/misc/asteroid/basalt/wasteland,
/area/ruin/unpowered/elephant_graveyard)
"yy" = (
/obj/item/storage/fancy/cigarettes/cigpack_mindbreaker,
/obj/structure/closet/crate/grave/filled,
/turf/open/misc/asteroid/basalt/wasteland,
/area/ruin/unpowered/elephant_graveyard)
"yG" = (
/obj/effect/decal/cleanable/oil/streak,
/obj/effect/decal/cleanable/glass,
/turf/open/misc/asteroid/basalt/wasteland,
/area/ruin/unpowered/elephant_graveyard)
"yQ" = (
/obj/structure/table,
/obj/machinery/power/floodlight,
/obj/structure/cable,
/turf/open/misc/asteroid/basalt/wasteland,
/area/ruin/unpowered/elephant_graveyard)
"zY" = (
/obj/effect/decal/cleanable/blood/drip,
/turf/open/misc/asteroid/basalt/wasteland,
/area/ruin/unpowered/elephant_graveyard)
"An" = (
/obj/machinery/power/shuttle_engine/heater,
/obj/structure/window/spawner/directional/north,
/obj/effect/decal/cleanable/cobweb/cobweb2,
/turf/open/floor/mineral/titanium/purple,
/area/ruin/powered/graveyard_shuttle)
"AB" = (
/obj/structure/bed,
/obj/item/wirecutters,
/turf/open/misc/asteroid/basalt/wasteland,
/area/ruin/unpowered/elephant_graveyard)
"AG" = (
/obj/item/paper/crumpled/muddy/fluff/elephant_graveyard/mutiny,
/obj/item/cigbutt,
/obj/item/cigbutt,
/turf/open/misc/asteroid/basalt/wasteland,
/area/ruin/unpowered/elephant_graveyard)
"AI" = (
/obj/structure/stone_tile/center/cracked,
/turf/open/misc/asteroid/basalt/wasteland,
/area/ruin/unpowered/elephant_graveyard)
"Bf" = (
/obj/structure/stone_tile/slab/cracked,
/obj/effect/decal/cleanable/dirt,
/turf/open/misc/asteroid/basalt/wasteland,
/area/ruin/unpowered/elephant_graveyard)
"Bo" = (
/obj/effect/decal/cleanable/dirt,
/turf/open/floor/mineral/titanium/white,
/area/ruin/powered/graveyard_shuttle)
"Br" = (
/obj/structure/cable,
/turf/open/misc/asteroid/basalt/wasteland,
/area/ruin/unpowered/elephant_graveyard)
"Bu" = (
/turf/open/misc/asteroid/basalt/lava_land_surface,
/area/ruin/unpowered/elephant_graveyard)
"BX" = (
/obj/structure/table,
/turf/closed/mineral/strong/wasteland,
/area/ruin/unpowered/elephant_graveyard)
"Cn" = (
/obj/structure/flora/rock/style_random,
/turf/open/misc/asteroid/basalt/wasteland,
/area/ruin/unpowered/elephant_graveyard)
"Cp" = (
/obj/item/stack/medical/gauze/improvised,
/obj/effect/decal/cleanable/dirt,
/turf/open/misc/asteroid/basalt/wasteland,
/area/ruin/unpowered/elephant_graveyard)
"Cu" = (
/turf/open/misc/asteroid/basalt/lava_land_surface,
/area/lavaland/surface)
"CM" = (
/obj/structure/cable,
/obj/item/food/deadmouse,
/obj/item/assembly/mousetrap,
/turf/open/misc/asteroid/basalt/wasteland,
/area/ruin/unpowered/elephant_graveyard)
"Dw" = (
/obj/structure/statue/bone/rib{
	dir = 1
	},
/turf/open/misc/asteroid/basalt/wasteland,
/area/ruin/unpowered/elephant_graveyard)
"DU" = (
/obj/structure/closet/wardrobe/curator,
/turf/open/misc/asteroid/basalt/wasteland,
/area/ruin/unpowered/elephant_graveyard)
"EA" = (
/obj/structure/table/optable,
/obj/item/storage/backpack/explorer,
/obj/item/reagent_containers/cup/soda_cans/cola,
/obj/item/restraints/handcuffs/cable/zipties/used,
/turf/open/floor/mineral/titanium/white,
/area/ruin/powered/graveyard_shuttle)
"EW" = (
/obj/structure/reagent_dispensers/fueltank,
/turf/open/misc/asteroid/basalt/wasteland,
/area/ruin/unpowered/elephant_graveyard)
"FC" = (
/obj/effect/decal/cleanable/blood/gibs/old,
/obj/effect/decal/cleanable/blood/splatter,
/turf/open/misc/asteroid/basalt/wasteland,
/area/ruin/unpowered/elephant_graveyard)
"GC" = (
/obj/effect/decal/cleanable/dirt,
/obj/item/cigbutt,
/turf/open/misc/asteroid/basalt/wasteland,
/area/ruin/unpowered/elephant_graveyard)
"Iy" = (
/obj/item/paper/fluff/ruins/elephant_graveyard,
/turf/open/misc/asteroid/basalt/lava_land_surface,
/area/lavaland/surface)
"IF" = (
/obj/item/light/bulb/broken,
/obj/effect/decal/cleanable/dirt,
/turf/open/floor/mineral/titanium/white,
/area/ruin/powered/graveyard_shuttle)
"IJ" = (
/obj/effect/decal/cleanable/generic,
/obj/item/cigbutt,
/turf/open/misc/asteroid/basalt/wasteland,
/area/ruin/unpowered/elephant_graveyard)
"Jd" = (
/obj/structure/stone_tile/cracked,
/turf/open/misc/asteroid/basalt/wasteland,
/area/ruin/unpowered/elephant_graveyard)
"JD" = (
/obj/structure/cable,
/obj/effect/decal/cleanable/dirt,
/turf/open/misc/asteroid/basalt/wasteland,
/area/ruin/unpowered/elephant_graveyard)
"JR" = (
/obj/structure/barricade/wooden,
/obj/structure/mineral_door/wood,
/turf/open/misc/asteroid/basalt/wasteland,
/area/ruin/unpowered/elephant_graveyard)
"Kq" = (
/obj/structure/barricade/wooden/crude,
/obj/structure/barricade/wooden,
/obj/effect/decal/cleanable/blood/splatter,
/turf/open/misc/asteroid/basalt/wasteland,
/area/ruin/unpowered/elephant_graveyard)
"Ks" = (
/obj/structure/barricade/sandbags,
/turf/open/misc/asteroid/basalt/wasteland,
/area/ruin/unpowered/elephant_graveyard)
"LR" = (
/obj/item/paper/fluff/ruins/elephant_graveyard,
/turf/open/misc/asteroid/basalt/wasteland,
/area/ruin/unpowered/elephant_graveyard)
"Mu" = (
/obj/structure/filingcabinet/chestdrawer,
/obj/item/clothing/mask/gas/explorer/folded,
/turf/open/floor/mineral/titanium/white,
/area/ruin/powered/graveyard_shuttle)
"Mx" = (
/obj/structure/flora/rock/style_random,
/obj/structure/cable,
/obj/item/pickaxe{
	pixel_x = -8;
	pixel_y = 5
	},
/turf/open/misc/asteroid/basalt/wasteland,
/area/ruin/unpowered/elephant_graveyard)
"MQ" = (
/obj/structure/table,
/obj/item/pen,
/obj/item/pen,
/obj/item/pen,
/turf/open/misc/asteroid/basalt/wasteland,
/area/ruin/unpowered/elephant_graveyard)
"MX" = (
/obj/structure/sign/warning/no_smoking/circle,
/turf/closed/wall/mineral/titanium,
/area/ruin/powered/graveyard_shuttle)
"NO" = (
/obj/effect/decal/cleanable/dirt,
/turf/open/misc/asteroid/basalt/lava_land_surface,
/area/ruin/unpowered/elephant_graveyard)
"Oq" = (
/obj/item/light/bulb/broken,
/obj/effect/turf_decal/caution/stand_clear/white,
/obj/effect/decal/cleanable/dirt,
/turf/open/floor/mineral/titanium/purple,
/area/ruin/powered/graveyard_shuttle)
"Ou" = (
/obj/structure/statue/bone/rib,
/turf/open/misc/asteroid/basalt/wasteland,
/area/ruin/unpowered/elephant_graveyard)
"OF" = (
/obj/structure/closet/emcloset,
/obj/item/light/bulb,
/obj/effect/turf_decal/box/white,
/turf/open/floor/mineral/titanium/purple,
/area/ruin/powered/graveyard_shuttle)
"OW" = (
/obj/structure/sign/warning/explosives,
/turf/closed/wall,
/area/ruin/unpowered/elephant_graveyard)
"Ql" = (
/obj/structure/barricade/wooden,
/obj/item/paper/fluff/ruins/elephant_graveyard,
/turf/open/misc/asteroid/basalt/wasteland,
/area/ruin/unpowered/elephant_graveyard)
"QD" = (
/obj/item/organ/internal/heart,
/obj/item/organ/internal/eyes,
/obj/item/organ/internal/ears,
/obj/effect/decal/cleanable/blood/gibs/old,
/turf/open/misc/asteroid/basalt/wasteland,
/area/ruin/unpowered/elephant_graveyard)
"St" = (
/obj/structure/table,
/obj/structure/cable,
/obj/item/paper_bin,
/turf/open/misc/asteroid/basalt/wasteland,
/area/ruin/unpowered/elephant_graveyard)
"TM" = (
/obj/item/cigbutt,
/turf/open/misc/asteroid/basalt/wasteland,
/area/ruin/unpowered/elephant_graveyard)
"Ux" = (
/obj/item/trash/can,
/obj/structure/bedsheetbin/empty,
/obj/structure/table,
/turf/open/misc/asteroid/basalt/wasteland,
/area/ruin/unpowered/elephant_graveyard)
"UE" = (
/obj/structure/sink/oil_well,
/turf/open/misc/asteroid/basalt/wasteland,
/area/ruin/unpowered/elephant_graveyard)
"UK" = (
/obj/structure/bed,
/obj/item/bedsheet/brown,
/turf/open/misc/asteroid/basalt/wasteland,
/area/ruin/unpowered/elephant_graveyard)
"VM" = (
/obj/structure/bed,
/obj/item/bedsheet/brown,
/obj/effect/decal/cleanable/dirt,
/turf/open/misc/asteroid/basalt/wasteland,
/area/ruin/unpowered/elephant_graveyard)
"VS" = (
/obj/structure/closet/crate/bin,
/obj/item/trash/candle,
/obj/item/trash/can/food/beans,
/obj/item/trash/can,
/obj/effect/decal/cleanable/dirt,
/obj/item/cigbutt,
/turf/open/misc/asteroid/basalt/wasteland,
/area/ruin/unpowered/elephant_graveyard)
"VY" = (
/obj/structure/table,
/obj/structure/cable,
/obj/item/paper/crumpled/muddy/fluff/elephant_graveyard/rnd_notes,
/turf/open/misc/asteroid/basalt/wasteland,
/area/ruin/unpowered/elephant_graveyard)
"Wf" = (
/obj/machinery/suit_storage_unit/mining/eva,
/obj/effect/turf_decal/box/white,
/turf/open/floor/mineral/titanium/purple,
/area/ruin/powered/graveyard_shuttle)
"Wt" = (
/obj/item/chair,
/turf/open/misc/asteroid/basalt/wasteland,
/area/ruin/unpowered/elephant_graveyard)
"WF" = (
/obj/structure/fence/door,
/turf/open/misc/asteroid/basalt/wasteland,
/area/ruin/unpowered/elephant_graveyard)
"WI" = (
/obj/effect/decal/cleanable/blood/tracks{
	dir = 4
	},
/obj/item/paper/fluff/ruins/elephant_graveyard/final_message,
/turf/open/misc/asteroid/basalt/wasteland,
/area/ruin/unpowered/elephant_graveyard)
"WX" = (
/obj/structure/statue/bone/skull/half,
/turf/open/misc/asteroid/basalt/wasteland,
/area/ruin/unpowered/elephant_graveyard)
"WZ" = (
/obj/effect/decal/cleanable/shreds,
/turf/open/misc/asteroid/basalt/wasteland,
/area/ruin/unpowered/elephant_graveyard)
"Xe" = (
/obj/structure/closet/crate/grave/filled,
/obj/effect/mob_spawn/corpse/human/skeleton,
/turf/open/misc/asteroid/basalt/wasteland,
/area/ruin/unpowered/elephant_graveyard)
"Xi" = (
/obj/effect/decal/cleanable/cobweb,
/obj/structure/closet/crate/grave/filled/lead_researcher,
/obj/effect/decal/cleanable/blood/gibs/old,
/obj/effect/mob_spawn/corpse/human/skeleton,
/turf/open/misc/asteroid/basalt/wasteland,
/area/ruin/unpowered/elephant_graveyard)
"XH" = (
/obj/item/organ/internal/lungs,
/obj/item/organ/internal/liver,
/obj/effect/decal/cleanable/blood/old,
/turf/open/misc/asteroid/basalt/wasteland,
/area/ruin/unpowered/elephant_graveyard)
"XI" = (
/obj/effect/decal/cleanable/glass,
/obj/effect/decal/cleanable/dirt,
/obj/machinery/door/airlock/shuttle{
	name = "Archaeology Shuttle Airlock"
	},
/turf/open/floor/mineral/titanium/purple,
/area/ruin/powered/graveyard_shuttle)
"XY" = (
/obj/structure/table,
/obj/structure/cable,
/obj/item/reagent_containers/cup/bottle/plasma{
	volume = 25
	},
/turf/open/misc/asteroid/basalt/wasteland,
/area/ruin/unpowered/elephant_graveyard)
"XZ" = (
/obj/structure/table,
/obj/structure/cable,
/obj/item/t_scanner/adv_mining_scanner/lesser,
/turf/open/misc/asteroid/basalt/wasteland,
/area/ruin/unpowered/elephant_graveyard)
"Yn" = (
/obj/structure/bed,
/obj/item/trash/pistachios,
/obj/item/trash/chips,
/obj/item/bedsheet/brown,
/obj/effect/decal/cleanable/dirt,
/turf/open/misc/asteroid/basalt/wasteland,
/area/ruin/unpowered/elephant_graveyard)
"Yq" = (
/obj/machinery/power/port_gen/pacman,
/obj/structure/cable,
/turf/open/misc/asteroid/basalt/wasteland,
/area/ruin/unpowered/elephant_graveyard)
"YD" = (
/obj/structure/table,
/obj/item/clothing/gloves/color/black,
/turf/open/misc/asteroid/basalt/wasteland,
/area/ruin/unpowered/elephant_graveyard)
"YF" = (
/obj/effect/decal/remains/human,
/obj/item/clothing/under/misc/overalls,
/obj/item/clothing/mask/bandana/green,
/turf/open/misc/asteroid/basalt/wasteland,
/area/ruin/unpowered/elephant_graveyard)
"YM" = (
/obj/effect/spawner/structure/window/reinforced/shuttle,
/turf/open/misc/asteroid/basalt/lava_land_surface,
/area/ruin/powered/graveyard_shuttle)
"ZH" = (
/obj/structure/stone_tile/surrounding_tile,
/turf/open/misc/asteroid/basalt/wasteland{
	icon_state = "wasteland_dug"
	},
/area/ruin/unpowered/elephant_graveyard)

(1,1,1) = {"
aa
aa
aa
aa
aa
aa
aa
aa
aa
aa
aa
aa
aa
aa
aa
ab
ab
ab
ab
ab
ab
ab
ab
aa
aa
aa
aa
aa
aa
aa
aa
aa
aa
aa
aa
"}
(2,1,1) = {"
aa
aa
aa
aa
aa
aa
aa
aa
aa
ab
ab
ab
at
ab
ab
ab
ac
ac
ac
ac
bf
ac
ab
ab
ab
aa
aa
aa
aa
aa
aa
aa
aa
aa
aa
"}
(3,1,1) = {"
aa
aa
aa
aa
aa
aa
aa
aa
ab
ab
bf
bf
bf
bf
bf
ac
ac
ac
ac
bf
bf
bf
ac
ac
ab
ab
ab
aa
aa
aa
aa
aa
aa
aa
aa
"}
(4,1,1) = {"
aa
aa
aa
aa
aa
aa
aa
ab
ab
bf
bf
VS
IJ
bf
bf
bf
ac
bf
bf
bf
bf
bf
bf
bf
ac
ac
ab
ab
aa
aa
aa
aa
aa
aa
aa
"}
(5,1,1) = {"
aa
aa
aa
aa
aa
ab
ab
ab
bf
bf
bf
AG
TM
GC
gB
bf
bf
bf
gu
dr
jI
bf
bf
bf
ac
ac
ac
ab
ab
ab
aa
aa
aa
aa
aa
"}
(6,1,1) = {"
aa
aa
aa
aa
ab
ab
bf
bf
bf
bf
aA
sV
aA
xh
gB
YF
gB
Xe
gB
gB
oK
WF
LR
gB
gB
ac
ac
ac
ac
ab
ab
ab
aa
aa
aa
"}
(7,1,1) = {"
aa
aa
aa
aa
ab
bf
bf
bf
eJ
Br
Br
Br
cH
gB
gB
tf
gB
gB
gB
gB
OW
bf
bf
bf
gB
ac
ac
ac
ac
ac
ac
ab
ab
aa
aa
"}
(8,1,1) = {"
aa
aa
ab
ab
ab
bf
bf
Br
Br
Cn
gB
gB
gB
Cn
qy
gB
km
gB
km
gB
gB
gB
gB
bf
gB
ac
ac
ac
ac
ac
ac
ac
ab
ab
aa
"}
(9,1,1) = {"
aa
ab
ab
bf
bf
bf
Br
Br
tf
gB
dr
gB
gB
gB
km
gB
zY
gB
gB
gB
km
gB
tf
bf
gB
gB
ac
ac
ac
ac
ac
ac
ac
ac
aa
"}
(10,1,1) = {"
ab
ab
bf
bf
bf
Br
JD
gB
gB
gB
gB
Xe
gB
gB
gB
ov
QD
qA
gB
gB
gB
gB
dr
bf
bf
gB
gB
ac
ac
ac
ac
li
yy
ac
ac
"}
(11,1,1) = {"
at
bf
bf
bf
bf
Br
gB
gB
WX
gB
Dw
Dw
Dw
Dw
gB
gB
XH
oL
gB
vS
gB
gB
UE
vk
bf
bf
dr
ac
ac
ac
ac
FC
gB
gB
ac
"}
(12,1,1) = {"
at
bf
bf
bf
bf
Br
Xe
gB
gB
gB
gB
ZH
do
Bf
gB
do
gB
nA
gB
gB
cZ
gB
gB
gB
bf
bf
Ks
ac
ac
ac
ac
ac
ac
Bu
ac
"}
(13,1,1) = {"
bf
Xi
gB
bf
Xe
Br
gB
gB
gB
gB
AI
gB
tf
tf
Jd
gB
nA
gB
kk
Cn
gB
Xe
gB
gB
bf
bf
gB
ac
ac
ac
ac
ac
ac
gB
ac
"}
(14,1,1) = {"
bf
WI
gB
bf
gB
Br
dr
gB
iR
gB
Ou
Ou
Ou
Ou
gB
gB
tf
gB
gB
UE
gB
gB
dr
eM
bf
Xe
dr
gB
ac
ac
ac
ac
ac
gB
ac
"}
(15,1,1) = {"
bf
jK
xr
bf
wa
Br
gB
gB
gB
gB
gB
gB
gB
gB
gB
gB
gB
vk
gB
gB
gB
gB
gB
Br
bf
ac
gB
gB
dr
ac
ac
ac
ac
Bu
ac
"}
(16,1,1) = {"
bf
jK
bf
bf
bf
Br
Br
Br
gB
gB
dr
gB
Cn
gB
km
gB
gB
gB
gB
gB
km
gB
gB
Br
bf
ac
ac
gB
gB
dr
ac
ac
ac
dr
iE
"}
(17,1,1) = {"
bf
gB
zY
bf
bf
dr
bf
Br
Mx
XZ
MQ
mH
YD
bX
gB
gB
km
gB
km
gB
gB
dr
Xe
Br
bf
bf
ac
ac
gB
Bu
ac
ac
ac
NO
Ql
"}
(18,1,1) = {"
at
bf
eu
bf
bf
zY
bf
gB
gB
VY
Wt
gB
gB
ek
gB
gB
dr
gB
gB
gB
gB
gB
gB
Br
Yq
bf
ac
ac
ac
gB
dr
dr
NO
dr
iE
"}
(19,1,1) = {"
ab
bf
zY
Kq
zY
gB
bf
gB
BX
XY
xz
gB
gB
pB
gB
Br
Br
Br
Br
Br
Br
Br
Br
CM
bf
bf
ac
ac
ac
ac
NO
dr
ac
ac
ac
"}
(20,1,1) = {"
aa
at
bf
bf
bf
bf
bf
JR
bf
yQ
qT
St
Br
Br
Br
rg
bf
ac
DU
gB
UE
bf
bf
bf
bf
ac
ac
ac
ac
ac
ac
ac
ac
ac
ac
"}
(21,1,1) = {"
aa
aa
ab
ac
ac
bf
UK
dr
bf
bf
bf
bf
nv
EW
gB
bf
bf
bf
bf
bf
bf
bf
bf
ac
ac
ac
ac
ac
ac
ac
ac
ac
ac
ab
ab
"}
(22,1,1) = {"
aa
aa
ab
ab
ac
bf
UK
gB
WZ
Ux
bf
bf
bf
bf
gB
bf
bf
bf
bf
ac
ac
ac
ac
ac
ac
ac
ac
ab
ab
ab
ab
ab
ab
Cu
Cu
"}
(23,1,1) = {"
aa
aa
aa
ab
ab
bf
VM
WZ
dr
Yn
bf
bf
bf
bf
yG
bf
bf
bf
bf
ab
ab
ab
ab
ab
ab
ab
ab
Cu
Cu
Cu
Iy
Cu
Cu
Cu
ab
"}
(24,1,1) = {"
aa
aa
aa
aa
ab
at
uj
Cp
gl
AB
bf
aH
aH
gM
XI
gM
aH
aH
aH
Iy
Cu
Cu
Cu
Cu
Cu
Cu
Cu
Cu
Cu
Cu
Cu
Cu
ab
ab
ab
"}
(25,1,1) = {"
aa
aa
aa
aa
aa
at
bf
bf
bf
bf
aH
aN
sl
bh
Bo
IF
OF
aH
aH
jx
Cu
Cu
Cu
Cu
Cu
Cu
Cu
Cu
Cu
ab
ab
ab
ab
ab
ab
"}
(26,1,1) = {"
aa
aa
aa
aa
aa
ab
ab
ab
ab
ab
YM
aO
oA
bi
bp
bi
Oq
An
aH
jx
Cu
Cu
Cu
Cu
ab
ab
ab
ab
ab
ab
ab
ab
ab
ab
ab
"}
(27,1,1) = {"
aa
aa
aa
aa
aa
aa
ab
ab
ab
ab
aH
aN
Mu
EA
bq
bS
Wf
aH
aH
jx
Cu
Cu
Cu
ab
ab
ab
ab
ab
ab
ab
ab
ab
ab
ab
aa
"}
(28,1,1) = {"
aa
aa
aa
aa
aa
aa
aa
ab
ab
ab
ab
aH
aH
aH
MX
aH
aH
aH
aH
Cu
Cu
ab
ab
ab
ab
ab
ab
ab
ab
ab
ab
ab
ab
aa
aa
"}
(29,1,1) = {"
aa
aa
aa
aa
aa
aa
aa
aa
ab
ab
ab
ab
ab
ab
ab
ab
ab
ab
ab
ab
ab
ab
ab
ab
ab
ab
ab
ab
ab
ab
aa
aa
aa
aa
aa
"}
