//MAP CONVERTED BY dmm2tgm.py THIS HEADER COMMENT PREVENTS RECONVERSION, DO NOT REMOVE
"a" = (
/turf/open/misc/asteroid/basalt/lava_land_surface,
/area/lavaland/surface/outdoors)
"c" = (
/turf/open/lava/smooth/lava_land_surface,
/area/lavaland/surface/outdoors)
"f" = (
/obj/structure/mirror/directional/east,
/obj/structure/stone_tile/center,
/obj/structure/stone_tile/surrounding_tile/burnt,
/obj/structure/stone_tile/surrounding_tile{
	dir = 1
	},
/obj/structure/stone_tile/surrounding_tile{
	dir = 8
	},
/turf/open/lava/smooth/weak,
/area/ruin/powered/pride)
"g" = (
/obj/structure/stone_tile/block/burnt{
	dir = 8
	},
/turf/open/lava/smooth/weak,
/area/ruin/powered/pride)
"h" = (
/obj/item/dyespray,
/obj/structure/table/wood/fancy/royalblue,
/obj/item/coin/silver,
/turf/open/floor/mineral/silver,
/area/ruin/powered/pride)
"j" = (
/obj/structure/mirror/magic/pride{
	pixel_y = -6
	},
/turf/closed/wall/mineral/silver,
/area/ruin/powered/pride)
"n" = (
/obj/structure/mirror/directional/west,
/turf/open/lava/smooth/weak,
/area/ruin/powered/pride)
"o" = (
/obj/structure/mirror/directional/east,
/turf/open/lava/smooth/weak,
/area/ruin/powered/pride)
"r" = (
/turf/open/floor/mineral/silver,
/area/ruin/powered/pride)
"t" = (
/obj/structure/stone_tile/center,
/obj/structure/stone_tile/surrounding_tile/cracked,
/obj/structure/stone_tile/surrounding_tile{
	dir = 1
	},
/obj/structure/stone_tile/surrounding_tile{
	dir = 8
	},
/turf/open/lava/smooth/weak,
/area/ruin/powered/pride)
"u" = (
/obj/structure/stone_tile/block/burnt{
	dir = 4
	},
/turf/open/lava/smooth/weak,
/area/ruin/powered/pride)
"y" = (
/obj/structure/stone_tile/center,
/obj/structure/stone_tile/surrounding,
/turf/open/lava/smooth/weak,
/area/ruin/powered/pride)
"z" = (
/obj/structure/stone_tile/center,
/obj/structure/stone_tile/surrounding/burnt,
/turf/open/lava/smooth/weak,
/area/ruin/powered/pride)
"B" = (
/obj/structure/stone_tile/center,
/obj/structure/stone_tile/surrounding_tile/cracked{
	dir = 4
	},
/obj/structure/stone_tile/surrounding_tile/cracked,
/obj/structure/stone_tile/surrounding_tile{
	dir = 8
	},
/turf/open/lava/smooth/weak,
/area/ruin/powered/pride)
"G" = (
/turf/closed/wall/mineral/cult,
/area/ruin/powered/pride)
"L" = (
/obj/structure/mirror/directional/west,
/obj/structure/stone_tile/surrounding_tile{
	dir = 8
	},
/turf/open/lava/smooth/weak,
/area/ruin/powered/pride)
"N" = (
/obj/structure/stone_tile/center,
/obj/structure/stone_tile/surrounding/burnt,
/obj/machinery/door/airlock/cult/unruned/friendly,
/turf/open/lava/smooth/weak,
/area/ruin/powered/pride)
"Q" = (
/obj/structure/mirror/directional/east,
/obj/structure/stone_tile/surrounding_tile,
/turf/open/lava/smooth/weak,
/area/ruin/powered/pride)
"S" = (
/obj/structure/stone_tile/block,
/obj/structure/stone_tile/surrounding_tile/cracked{
	dir = 4
	},
/obj/structure/stone_tile/surrounding_tile{
	dir = 1
	},
/turf/open/lava/smooth/weak,
/area/ruin/powered/pride)
"U" = (
/obj/structure/stone_tile/block{
	dir = 8
	},
/turf/open/lava/smooth/weak,
/area/ruin/powered/pride)
"V" = (
/obj/item/clothing/under/chameleon{
	armor = null
	},
/obj/structure/table/wood/fancy/royalblue,
/turf/open/floor/mineral/silver,
/area/ruin/powered/pride)
"W" = (
/obj/structure/mirror/directional/west,
/obj/structure/stone_tile/center,
/obj/structure/stone_tile/surrounding_tile/burnt{
	dir = 4
	},
/obj/structure/stone_tile/surrounding_tile{
	dir = 8
	},
/obj/structure/stone_tile/surrounding_tile,
/turf/open/lava/smooth/weak,
/area/ruin/powered/pride)
"Y" = (
/turf/closed/indestructible/riveted/boss,
/area/ruin/powered/pride)
"Z" = (
/obj/structure/stone_tile/block{
	dir = 4
	},
/turf/open/lava/smooth/weak,
/area/ruin/powered/pride)

(1,1,1) = {"
a
a
c
a
a
a
a
a
c
c
a
a
"}
(2,1,1) = {"
a
c
c
G
Y
Y
Y
G
G
G
c
a
"}
(3,1,1) = {"
c
c
Y
Y
W
L
n
n
n
G
c
a
"}
(4,1,1) = {"
c
c
G
h
r
B
g
U
U
Y
Y
a
"}
(5,1,1) = {"
c
c
G
j
r
S
y
z
y
z
N
a
"}
(6,1,1) = {"
c
c
G
V
r
t
u
Z
u
Y
Y
a
"}
(7,1,1) = {"
c
c
Y
Y
f
Q
o
o
o
Y
c
a
"}
(8,1,1) = {"
a
c
c
G
G
G
Y
Y
G
G
c
a
"}
(9,1,1) = {"
a
a
c
c
a
a
a
a
a
c
c
a
"}
