//MAP CONVERTED BY dmm2tgm.py THIS HEADER COMMENT PREVENTS RECONVERSION, DO NOT REMOVE
"aa" = (
/turf/open/water,
/area/awaymission/beach)
"ab" = (
/turf/open/lava,
/area/awaymission/caves)
"ea" = (
/obj/effect/landmark/abductor/scientist{
	team_number = 2
	},
/turf/open/floor/plating/abductor,
/area/centcom/abductor_ship)
"eq" = (
/obj/machinery/abductor/pad{
	team_number = 3
	},
/turf/open/floor/plating/abductor,
/area/centcom/abductor_ship)
"es" = (
/obj/machinery/abductor/experiment{
	team_number = 3
	},
/turf/open/floor/plating/abductor,
/area/centcom/abductor_ship)
"eF" = (
/obj/structure/table/abductor,
/obj/item/toy/plush/abductor{
	pixel_x = -7;
	pixel_y = 14
	},
/obj/item/toy/plush/abductor/agent{
	pixel_x = 9;
	pixel_y = 2
	},
/turf/open/floor/plating/abductor,
/area/centcom/abductor_ship)
"eI" = (
/turf/closed/indestructible/abductor{
	icon_state = "alien10"
	},
/area/centcom/abductor_ship)
"fq" = (
/turf/closed/indestructible/abductor{
	icon_state = "alien3"
	},
/area/centcom/abductor_ship)
"hb" = (
/turf/closed/indestructible/abductor{
	icon_state = "alien6"
	},
/area/centcom/abductor_ship)
"ie" = (
/obj/structure/closet/abductor,
/obj/item/storage/box/alienhandcuffs,
/obj/item/reagent_containers/cup/beaker/synthflesh,
/turf/open/floor/plating/abductor,
/area/centcom/abductor_ship)
"lu" = (
/turf/closed/indestructible/abductor{
	icon_state = "alien22"
	},
/area/centcom/abductor_ship)
"lH" = (
/turf/closed/indestructible/abductor{
	icon_state = "alien14"
	},
/area/centcom/abductor_ship)
"lV" = (
/turf/closed/indestructible/abductor,
/area/centcom/abductor_ship)
"mr" = (
/obj/machinery/limbgrower/fullupgrade,
/turf/open/floor/plating/abductor,
/area/centcom/abductor_ship)
"nb" = (
/obj/machinery/abductor/experiment{
	team_number = 1
	},
/turf/open/floor/plating/abductor,
/area/centcom/abductor_ship)
"nt" = (
/obj/structure/bed/abductor,
/turf/open/floor/plating/abductor,
/area/centcom/abductor_ship)
"nL" = (
/obj/machinery/computer/camera_advanced/abductor{
	team_number = 3
	},
/turf/open/floor/plating/abductor,
/area/centcom/abductor_ship)
"oa" = (
/turf/closed/indestructible/abductor{
	icon_state = "alien12"
	},
/area/centcom/abductor_ship)
"pb" = (
/turf/closed/indestructible/abductor{
	icon_state = "alien5"
	},
/area/centcom/abductor_ship)
"pK" = (
/obj/machinery/abductor/console{
	team_number = 3
	},
/turf/open/floor/plating/abductor,
/area/centcom/abductor_ship)
"qV" = (
/obj/machinery/abductor/pad{
	team_number = 1
	},
/turf/open/floor/plating/abductor,
/area/centcom/abductor_ship)
"rh" = (
/obj/item/scalpel/alien{
	pixel_y = 7
	},
/obj/structure/table/abductor,
/obj/item/cautery/alien{
	pixel_y = 15
	},
/obj/item/circular_saw/alien{
	pixel_y = -2
	},
/turf/open/floor/plating/abductor,
/area/centcom/abductor_ship)
"so" = (
/turf/closed/indestructible/abductor{
	icon_state = "alien24"
	},
/area/centcom/abductor_ship)
"tu" = (
/obj/structure/table/abductor,
/obj/item/hemostat/alien{
	pixel_y = 16
	},
/obj/item/surgicaldrill/alien{
	pixel_y = -7
	},
/obj/item/retractor/alien{
	pixel_y = 4
	},
/turf/open/floor/plating/abductor,
/area/centcom/abductor_ship)
"tL" = (
/obj/effect/landmark/abductor/scientist{
	team_number = 4
	},
/turf/open/floor/plating/abductor,
/area/centcom/abductor_ship)
"tT" = (
/obj/machinery/abductor/pad{
	team_number = 4
	},
/turf/open/floor/plating/abductor,
/area/centcom/abductor_ship)
"ub" = (
/turf/closed/indestructible/abductor{
	icon_state = "alien4"
	},
/area/centcom/abductor_ship)
"vd" = (
/turf/closed/indestructible/abductor{
	icon_state = "alien17"
	},
/area/centcom/abductor_ship)
"vj" = (
/turf/closed/indestructible/abductor{
	icon_state = "alien20"
	},
/area/centcom/abductor_ship)
"wM" = (
/obj/effect/landmark/abductor/scientist{
	team_number = 3
	},
/turf/open/floor/plating/abductor,
/area/centcom/abductor_ship)
"xf" = (
/obj/machinery/abductor/pad{
	team_number = 2
	},
/turf/open/floor/plating/abductor,
/area/centcom/abductor_ship)
"xM" = (
/obj/machinery/abductor/console{
	team_number = 1
	},
/turf/open/floor/plating/abductor,
/area/centcom/abductor_ship)
"xR" = (
/obj/machinery/abductor/console{
	team_number = 4
	},
/turf/open/floor/plating/abductor,
/area/centcom/abductor_ship)
"ze" = (
/obj/machinery/abductor/experiment{
	team_number = 2
	},
/turf/open/floor/plating/abductor,
/area/centcom/abductor_ship)
"zV" = (
/obj/machinery/computer/camera_advanced/abductor{
	team_number = 2
	},
/turf/open/floor/plating/abductor,
/area/centcom/abductor_ship)
"Bh" = (
/obj/machinery/abductor/gland_dispenser,
/turf/open/floor/plating/abductor,
/area/centcom/abductor_ship)
"CF" = (
/obj/machinery/abductor/console{
	team_number = 2
	},
/turf/open/floor/plating/abductor,
/area/centcom/abductor_ship)
"DL" = (
/obj/effect/landmark/abductor/agent{
	team_number = 4
	},
/turf/open/floor/plating/abductor,
/area/centcom/abductor_ship)
"Ep" = (
/turf/closed/indestructible/abductor{
	icon_state = "alien11"
	},
/area/centcom/abductor_ship)
"EG" = (
/turf/closed/indestructible/abductor{
	icon_state = "alien18"
	},
/area/centcom/abductor_ship)
"FU" = (
/turf/closed/indestructible/abductor{
	icon_state = "alien15"
	},
/area/centcom/abductor_ship)
"Gs" = (
/obj/machinery/computer/camera_advanced/abductor{
	team_number = 4
	},
/turf/open/floor/plating/abductor,
/area/centcom/abductor_ship)
"GM" = (
/obj/structure/table/optable/abductor,
/obj/item/surgical_drapes{
	pixel_y = -5
	},
/turf/open/floor/plating/abductor,
/area/centcom/abductor_ship)
"HK" = (
/obj/effect/landmark/abductor/agent{
	team_number = 2
	},
/turf/open/floor/plating/abductor,
/area/centcom/abductor_ship)
"HN" = (
/turf/closed/indestructible/abductor{
	icon_state = "alien8"
	},
/area/centcom/abductor_ship)
"HW" = (
/turf/closed/indestructible/abductor{
	icon_state = "alien13"
	},
/area/centcom/abductor_ship)
"KC" = (
/turf/closed/indestructible/abductor{
	icon_state = "alien7"
	},
/area/centcom/abductor_ship)
"MX" = (
/obj/structure/table/abductor,
/obj/machinery/recharger{
	pixel_x = 7
	},
/obj/item/paper/guides/antag/abductor{
	pixel_x = -5
	},
/turf/open/floor/plating/abductor,
/area/centcom/abductor_ship)
"Pv" = (
/obj/effect/landmark/abductor/agent{
	team_number = 3
	},
/turf/open/floor/plating/abductor,
/area/centcom/abductor_ship)
"Ql" = (
/turf/closed/indestructible/abductor{
	icon_state = "alien2"
	},
/area/centcom/abductor_ship)
"UE" = (
/turf/open/floor/plating/abductor,
/area/centcom/abductor_ship)
"VK" = (
/turf/closed/indestructible/abductor{
	icon_state = "alien23"
	},
/area/centcom/abductor_ship)
"VZ" = (
/obj/effect/landmark/abductor/agent,
/turf/open/floor/plating/abductor,
/area/centcom/abductor_ship)
"Wn" = (
/turf/closed/indestructible/abductor{
	icon_state = "alien19"
	},
/area/centcom/abductor_ship)
"Xy" = (
/turf/cordon,
/area/misc/cordon)
"XD" = (
/obj/machinery/computer/camera_advanced/abductor{
	team_number = 1
	},
/turf/open/floor/plating/abductor,
/area/centcom/abductor_ship)
"Yf" = (
/turf/closed/indestructible/abductor{
	icon_state = "alien9"
	},
/area/centcom/abductor_ship)
"Yv" = (
/turf/closed/indestructible/abductor{
	icon_state = "alien21"
	},
/area/centcom/abductor_ship)
"YT" = (
/turf/closed/indestructible/abductor{
	icon_state = "alien16"
	},
/area/centcom/abductor_ship)
"YY" = (
/obj/machinery/abductor/experiment{
	team_number = 4
	},
/turf/open/floor/plating/abductor,
/area/centcom/abductor_ship)
"Zn" = (
/obj/effect/landmark/abductor/scientist,
/turf/open/floor/plating/abductor,
/area/centcom/abductor_ship)

(1,1,1) = {"
Xy
YT
lH
oa
eI
hb
Xy
Xy
Xy
YT
lH
oa
eI
hb
Xy
"}
(2,1,1) = {"
vj
vd
nL
tu
rh
KC
lV
Xy
vj
vd
XD
tu
rh
KC
lV
"}
(3,1,1) = {"
Yv
es
UE
wM
UE
Bh
Ql
Xy
Yv
nb
UE
Zn
UE
Bh
Ql
"}
(4,1,1) = {"
lu
pK
UE
GM
UE
eF
fq
Xy
lu
xM
UE
GM
UE
eF
fq
"}
(5,1,1) = {"
VK
eq
UE
Pv
UE
nt
ub
Xy
VK
qV
UE
VZ
UE
nt
ub
"}
(6,1,1) = {"
so
EG
ie
MX
mr
HN
pb
Xy
so
EG
ie
MX
mr
HN
pb
"}
(7,1,1) = {"
Xy
Wn
FU
HW
Ep
Yf
Xy
Xy
Xy
Wn
FU
HW
Ep
Yf
Xy
"}
(8,1,1) = {"
Xy
Xy
Xy
Xy
Xy
Xy
Xy
Xy
Xy
Xy
Xy
Xy
Xy
Xy
Xy
"}
(9,1,1) = {"
Xy
YT
lH
oa
eI
hb
Xy
Xy
Xy
YT
lH
oa
eI
hb
Xy
"}
(10,1,1) = {"
vj
vd
Gs
tu
rh
KC
lV
Xy
vj
vd
zV
tu
rh
KC
lV
"}
(11,1,1) = {"
Yv
YY
UE
tL
UE
Bh
Ql
Xy
Yv
ze
UE
ea
UE
Bh
Ql
"}
(12,1,1) = {"
lu
xR
UE
GM
UE
eF
fq
Xy
lu
CF
UE
GM
UE
eF
fq
"}
(13,1,1) = {"
VK
tT
UE
DL
UE
nt
ub
Xy
VK
xf
UE
HK
UE
nt
ub
"}
(14,1,1) = {"
so
EG
ie
MX
mr
HN
pb
Xy
so
EG
ie
MX
mr
HN
pb
"}
(15,1,1) = {"
Xy
Wn
FU
HW
Ep
Yf
Xy
Xy
Xy
Wn
FU
HW
Ep
Yf
Xy
"}

(1,1,2) = {"
aa
aa
aa
aa
aa
aa
aa
aa
aa
aa
aa
aa
aa
aa
aa
"}
(2,1,2) = {"
aa
aa
aa
aa
aa
aa
aa
aa
aa
aa
aa
aa
aa
aa
aa
"}
(3,1,2) = {"
aa
aa
aa
aa
aa
aa
aa
aa
aa
aa
aa
aa
aa
aa
aa
"}
(4,1,2) = {"
aa
aa
aa
aa
aa
aa
aa
aa
aa
aa
aa
aa
aa
aa
aa
"}
(5,1,2) = {"
aa
aa
aa
aa
aa
aa
aa
aa
aa
aa
aa
aa
aa
aa
aa
"}
(6,1,2) = {"
aa
aa
aa
aa
aa
aa
aa
aa
aa
aa
aa
aa
aa
aa
aa
"}
(7,1,2) = {"
aa
aa
aa
aa
aa
aa
aa
aa
aa
aa
aa
aa
aa
aa
aa
"}
(8,1,2) = {"
aa
aa
aa
aa
aa
aa
aa
aa
aa
aa
aa
aa
aa
aa
aa
"}
(9,1,2) = {"
aa
aa
aa
aa
aa
aa
aa
aa
aa
aa
aa
aa
aa
aa
aa
"}
(10,1,2) = {"
aa
aa
aa
aa
aa
aa
aa
aa
aa
aa
aa
aa
aa
aa
aa
"}
(11,1,2) = {"
aa
aa
aa
aa
aa
aa
aa
aa
aa
aa
aa
aa
aa
aa
aa
"}
(12,1,2) = {"
aa
aa
aa
aa
aa
aa
aa
aa
aa
aa
aa
aa
aa
aa
aa
"}
(13,1,2) = {"
aa
aa
aa
aa
aa
aa
aa
aa
aa
aa
aa
aa
aa
aa
aa
"}
(14,1,2) = {"
aa
aa
aa
aa
aa
aa
aa
aa
aa
aa
aa
aa
aa
aa
aa
"}
(15,1,2) = {"
aa
aa
aa
aa
aa
aa
aa
aa
aa
aa
aa
aa
aa
aa
aa
"}

(1,1,3) = {"
ab
ab
ab
ab
ab
ab
ab
ab
ab
ab
ab
ab
ab
ab
ab
"}
(2,1,3) = {"
ab
ab
ab
ab
ab
ab
ab
ab
ab
ab
ab
ab
ab
ab
ab
"}
(3,1,3) = {"
ab
ab
ab
ab
ab
ab
ab
ab
ab
ab
ab
ab
ab
ab
ab
"}
(4,1,3) = {"
ab
ab
ab
ab
ab
ab
ab
ab
ab
ab
ab
ab
ab
ab
ab
"}
(5,1,3) = {"
ab
ab
ab
ab
ab
ab
ab
ab
ab
ab
ab
ab
ab
ab
ab
"}
(6,1,3) = {"
ab
ab
ab
ab
ab
ab
ab
ab
ab
ab
ab
ab
ab
ab
ab
"}
(7,1,3) = {"
ab
ab
ab
ab
ab
ab
ab
ab
ab
ab
ab
ab
ab
ab
ab
"}
(8,1,3) = {"
ab
ab
ab
ab
ab
ab
ab
ab
ab
ab
ab
ab
ab
ab
ab
"}
(9,1,3) = {"
ab
ab
ab
ab
ab
ab
ab
ab
ab
ab
ab
ab
ab
ab
ab
"}
(10,1,3) = {"
ab
ab
ab
ab
ab
ab
ab
ab
ab
ab
ab
ab
ab
ab
ab
"}
(11,1,3) = {"
ab
ab
ab
ab
ab
ab
ab
ab
ab
ab
ab
ab
ab
ab
ab
"}
(12,1,3) = {"
ab
ab
ab
ab
ab
ab
ab
ab
ab
ab
ab
ab
ab
ab
ab
"}
(13,1,3) = {"
ab
ab
ab
ab
ab
ab
ab
ab
ab
ab
ab
ab
ab
ab
ab
"}
(14,1,3) = {"
ab
ab
ab
ab
ab
ab
ab
ab
ab
ab
ab
ab
ab
ab
ab
"}
(15,1,3) = {"
ab
ab
ab
ab
ab
ab
ab
ab
ab
ab
ab
ab
ab
ab
ab
"}
