//MAP CONVERTED BY dmm2tgm.py THIS HEADER COMMENT PREVENTS RECONVERSION, DO NOT REMOVE
"aa" = (
/turf/open/water,
/area/awaymission/beach)
"ab" = (
/turf/open/lava,
/area/awaymission/caves)
"aP" = (
/turf/closed/indestructible/abductor{
	icon_state = "alien16"
	},
/area/centcom/abductor_ship)
"ea" = (
/obj/effect/landmark/abductor/scientist{
	team_number = 2
	},
/turf/open/floor/plating/abductor,
/area/centcom/abductor_ship)
"eq" = (
/obj/machinery/abductor/pad{
	team_number = 3
	},
/turf/open/floor/plating/abductor,
/area/centcom/abductor_ship)
"es" = (
/obj/machinery/abductor/experiment{
	team_number = 3
	},
/turf/open/floor/plating/abductor,
/area/centcom/abductor_ship)
"fB" = (
/turf/closed/indestructible/abductor{
	icon_state = "alien2"
	},
/area/centcom/abductor_ship)
"fD" = (
/turf/closed/indestructible/abductor{
	icon_state = "alien5"
	},
/area/centcom/abductor_ship)
"ie" = (
/obj/structure/closet/abductor,
/obj/item/storage/box/alienhandcuffs,
/obj/item/reagent_containers/cup/beaker/synthflesh,
/turf/open/floor/plating/abductor,
/area/centcom/abductor_ship)
"lV" = (
/turf/closed/indestructible/abductor,
/area/centcom/abductor_ship)
"mr" = (
/obj/machinery/limbgrower/fullupgrade,
/turf/open/floor/plating/abductor,
/area/centcom/abductor_ship)
"nb" = (
/obj/machinery/abductor/experiment{
	team_number = 1
	},
/turf/open/floor/plating/abductor,
/area/centcom/abductor_ship)
"nt" = (
/obj/structure/bed/abductor,
/turf/open/floor/plating/abductor,
/area/centcom/abductor_ship)
"nL" = (
/obj/machinery/computer/camera_advanced/abductor{
	team_number = 3
	},
/turf/open/floor/plating/abductor,
/area/centcom/abductor_ship)
"pA" = (
/turf/closed/indestructible/abductor{
	icon_state = "alien23"
	},
/area/centcom/abductor_ship)
"pK" = (
/obj/machinery/abductor/console{
	team_number = 3
	},
/turf/open/floor/plating/abductor,
/area/centcom/abductor_ship)
"qp" = (
/turf/closed/indestructible/abductor{
	icon_state = "alien4"
	},
/area/centcom/abductor_ship)
"qV" = (
/obj/machinery/abductor/pad{
	team_number = 1
	},
/turf/open/floor/plating/abductor,
/area/centcom/abductor_ship)
"rh" = (
/obj/item/scalpel/alien{
	pixel_y = 7
	},
/obj/structure/table/abductor,
/obj/item/cautery/alien{
	pixel_y = 15
	},
/obj/item/circular_saw/alien{
	pixel_y = -2
	},
/turf/open/floor/plating/abductor,
/area/centcom/abductor_ship)
"ri" = (
/turf/closed/indestructible/abductor{
	icon_state = "alien8"
	},
/area/centcom/abductor_ship)
"si" = (
/turf/closed/indestructible/abductor{
	icon_state = "alien6"
	},
/area/centcom/abductor_ship)
"sS" = (
/obj/structure/table/abductor,
/obj/machinery/recharger{
	pixel_x = 7
	},
/obj/item/paper/guides/antag/abductor{
	pixel_x = -5
	},
/turf/open/floor/plating/abductor,
/area/centcom/abductor_ship)
"tp" = (
/turf/closed/indestructible/abductor{
	icon_state = "alien14"
	},
/area/centcom/abductor_ship)
"tu" = (
/obj/structure/table/abductor,
/obj/item/hemostat/alien{
	pixel_y = 16
	},
/obj/item/surgicaldrill/alien{
	pixel_y = -7
	},
/obj/item/retractor/alien{
	pixel_y = 4
	},
/turf/open/floor/plating/abductor,
/area/centcom/abductor_ship)
"tL" = (
/obj/effect/landmark/abductor/scientist{
	team_number = 4
	},
/turf/open/floor/plating/abductor,
/area/centcom/abductor_ship)
"tQ" = (
/turf/closed/indestructible/abductor{
	icon_state = "alien20"
	},
/area/centcom/abductor_ship)
"tT" = (
/obj/machinery/abductor/pad{
	team_number = 4
	},
/turf/open/floor/plating/abductor,
/area/centcom/abductor_ship)
"wC" = (
/turf/closed/indestructible/abductor{
	icon_state = "alien19"
	},
/area/centcom/abductor_ship)
"wM" = (
/obj/effect/landmark/abductor/scientist{
	team_number = 3
	},
/turf/open/floor/plating/abductor,
/area/centcom/abductor_ship)
"xf" = (
/obj/machinery/abductor/pad{
	team_number = 2
	},
/turf/open/floor/plating/abductor,
/area/centcom/abductor_ship)
"xy" = (
/turf/closed/indestructible/abductor{
	icon_state = "alien12"
	},
/area/centcom/abductor_ship)
"xM" = (
/obj/machinery/abductor/console{
	team_number = 1
	},
/turf/open/floor/plating/abductor,
/area/centcom/abductor_ship)
"xR" = (
/obj/machinery/abductor/console{
	team_number = 4
	},
/turf/open/floor/plating/abductor,
/area/centcom/abductor_ship)
"xX" = (
/turf/closed/indestructible/abductor{
	icon_state = "alien10"
	},
/area/centcom/abductor_ship)
"ze" = (
/obj/machinery/abductor/experiment{
	team_number = 2
	},
/turf/open/floor/plating/abductor,
/area/centcom/abductor_ship)
"zV" = (
/obj/machinery/computer/camera_advanced/abductor{
	team_number = 2
	},
/turf/open/floor/plating/abductor,
/area/centcom/abductor_ship)
"Bh" = (
/obj/machinery/abductor/gland_dispenser,
/turf/open/floor/plating/abductor,
/area/centcom/abductor_ship)
"Bk" = (
/turf/closed/indestructible/abductor{
	icon_state = "alien24"
	},
/area/centcom/abductor_ship)
"BM" = (
/turf/closed/indestructible/abductor{
	icon_state = "alien7"
	},
/area/centcom/abductor_ship)
"Cq" = (
/turf/closed/indestructible/abductor{
	icon_state = "alien3"
	},
/area/centcom/abductor_ship)
"CF" = (
/obj/machinery/abductor/console{
	team_number = 2
	},
/turf/open/floor/plating/abductor,
/area/centcom/abductor_ship)
"DL" = (
/obj/effect/landmark/abductor/agent{
	team_number = 4
	},
/turf/open/floor/plating/abductor,
/area/centcom/abductor_ship)
"Gs" = (
/obj/machinery/computer/camera_advanced/abductor{
	team_number = 4
	},
/turf/open/floor/plating/abductor,
/area/centcom/abductor_ship)
"GF" = (
/turf/closed/indestructible/abductor{
	icon_state = "alien22"
	},
/area/centcom/abductor_ship)
"HK" = (
/obj/effect/landmark/abductor/agent{
	team_number = 2
	},
/turf/open/floor/plating/abductor,
/area/centcom/abductor_ship)
"Il" = (
/obj/structure/table/optable/abductor,
/obj/item/surgical_drapes{
	pixel_y = -5
	},
/turf/open/floor/plating/abductor,
/area/centcom/abductor_ship)
"Jf" = (
/turf/closed/indestructible/abductor{
	icon_state = "alien11"
	},
/area/centcom/abductor_ship)
"OA" = (
/turf/closed/indestructible/abductor{
	icon_state = "alien9"
	},
/area/centcom/abductor_ship)
"OY" = (
/turf/closed/indestructible/abductor{
	icon_state = "alien13"
	},
/area/centcom/abductor_ship)
"Pt" = (
/turf/closed/indestructible/abductor{
	icon_state = "alien17"
	},
/area/centcom/abductor_ship)
"Pv" = (
/obj/effect/landmark/abductor/agent{
	team_number = 3
	},
/turf/open/floor/plating/abductor,
/area/centcom/abductor_ship)
"RU" = (
/turf/closed/indestructible/abductor{
	icon_state = "alien15"
	},
/area/centcom/abductor_ship)
"SK" = (
/obj/structure/table/abductor,
/obj/item/toy/plush/abductor{
	pixel_x = -7;
	pixel_y = 14
	},
/obj/item/toy/plush/abductor/agent{
	pixel_x = 9;
	pixel_y = 2
	},
/turf/open/floor/plating/abductor,
/area/centcom/abductor_ship)
"UE" = (
/turf/open/floor/plating/abductor,
/area/centcom/abductor_ship)
"VZ" = (
/obj/effect/landmark/abductor/agent,
/turf/open/floor/plating/abductor,
/area/centcom/abductor_ship)
"WJ" = (
/turf/closed/indestructible/abductor{
	icon_state = "alien18"
	},
/area/centcom/abductor_ship)
"Xy" = (
/turf/cordon,
/area/misc/cordon)
"XD" = (
/obj/machinery/computer/camera_advanced/abductor{
	team_number = 1
	},
/turf/open/floor/plating/abductor,
/area/centcom/abductor_ship)
"YY" = (
/obj/machinery/abductor/experiment{
	team_number = 4
	},
/turf/open/floor/plating/abductor,
/area/centcom/abductor_ship)
"Zn" = (
/obj/effect/landmark/abductor/scientist,
/turf/open/floor/plating/abductor,
/area/centcom/abductor_ship)
"Zp" = (
/turf/closed/indestructible/abductor{
	icon_state = "alien21"
	},
/area/centcom/abductor_ship)

(1,1,1) = {"
Xy
aP
tp
xy
xX
si
Xy
Xy
Xy
aP
tp
xy
xX
si
Xy
"}
(2,1,1) = {"
tQ
Pt
nL
tu
rh
BM
lV
Xy
tQ
Pt
XD
tu
rh
BM
lV
"}
(3,1,1) = {"
Zp
es
UE
wM
UE
Bh
fB
Xy
Zp
nb
UE
Zn
UE
Bh
fB
"}
(4,1,1) = {"
GF
pK
UE
Il
UE
SK
Cq
Xy
GF
xM
UE
Il
UE
SK
Cq
"}
(5,1,1) = {"
pA
eq
UE
Pv
UE
nt
qp
Xy
pA
qV
UE
VZ
UE
nt
qp
"}
(6,1,1) = {"
Bk
WJ
ie
sS
mr
ri
fD
Xy
Bk
WJ
ie
sS
mr
ri
fD
"}
(7,1,1) = {"
Xy
wC
RU
OY
Jf
OA
Xy
Xy
Xy
wC
RU
OY
Jf
OA
Xy
"}
(8,1,1) = {"
Xy
Xy
Xy
Xy
Xy
Xy
Xy
Xy
Xy
Xy
Xy
Xy
Xy
Xy
Xy
"}
(9,1,1) = {"
Xy
aP
tp
xy
xX
si
Xy
Xy
Xy
aP
tp
xy
xX
si
Xy
"}
(10,1,1) = {"
tQ
Pt
Gs
tu
rh
BM
lV
Xy
tQ
Pt
zV
tu
rh
BM
lV
"}
(11,1,1) = {"
Zp
YY
UE
tL
UE
Bh
fB
Xy
Zp
ze
UE
ea
UE
Bh
fB
"}
(12,1,1) = {"
GF
xR
UE
Il
UE
SK
Cq
Xy
GF
CF
UE
Il
UE
SK
Cq
"}
(13,1,1) = {"
pA
tT
UE
DL
UE
nt
qp
Xy
pA
xf
UE
HK
UE
nt
qp
"}
(14,1,1) = {"
Bk
WJ
ie
sS
mr
ri
fD
Xy
Bk
WJ
ie
sS
mr
ri
fD
"}
(15,1,1) = {"
Xy
wC
RU
OY
Jf
OA
Xy
Xy
Xy
wC
RU
OY
Jf
OA
Xy
"}

(1,1,2) = {"
aa
aa
aa
aa
aa
aa
aa
aa
aa
aa
aa
aa
aa
aa
aa
"}
(2,1,2) = {"
aa
aa
aa
aa
aa
aa
aa
aa
aa
aa
aa
aa
aa
aa
aa
"}
(3,1,2) = {"
aa
aa
aa
aa
aa
aa
aa
aa
aa
aa
aa
aa
aa
aa
aa
"}
(4,1,2) = {"
aa
aa
aa
aa
aa
aa
aa
aa
aa
aa
aa
aa
aa
aa
aa
"}
(5,1,2) = {"
aa
aa
aa
aa
aa
aa
aa
aa
aa
aa
aa
aa
aa
aa
aa
"}
(6,1,2) = {"
aa
aa
aa
aa
aa
aa
aa
aa
aa
aa
aa
aa
aa
aa
aa
"}
(7,1,2) = {"
aa
aa
aa
aa
aa
aa
aa
aa
aa
aa
aa
aa
aa
aa
aa
"}
(8,1,2) = {"
aa
aa
aa
aa
aa
aa
aa
aa
aa
aa
aa
aa
aa
aa
aa
"}
(9,1,2) = {"
aa
aa
aa
aa
aa
aa
aa
aa
aa
aa
aa
aa
aa
aa
aa
"}
(10,1,2) = {"
aa
aa
aa
aa
aa
aa
aa
aa
aa
aa
aa
aa
aa
aa
aa
"}
(11,1,2) = {"
aa
aa
aa
aa
aa
aa
aa
aa
aa
aa
aa
aa
aa
aa
aa
"}
(12,1,2) = {"
aa
aa
aa
aa
aa
aa
aa
aa
aa
aa
aa
aa
aa
aa
aa
"}
(13,1,2) = {"
aa
aa
aa
aa
aa
aa
aa
aa
aa
aa
aa
aa
aa
aa
aa
"}
(14,1,2) = {"
aa
aa
aa
aa
aa
aa
aa
aa
aa
aa
aa
aa
aa
aa
aa
"}
(15,1,2) = {"
aa
aa
aa
aa
aa
aa
aa
aa
aa
aa
aa
aa
aa
aa
aa
"}

(1,1,3) = {"
ab
ab
ab
ab
ab
ab
ab
ab
ab
ab
ab
ab
ab
ab
ab
"}
(2,1,3) = {"
ab
ab
ab
ab
ab
ab
ab
ab
ab
ab
ab
ab
ab
ab
ab
"}
(3,1,3) = {"
ab
ab
ab
ab
ab
ab
ab
ab
ab
ab
ab
ab
ab
ab
ab
"}
(4,1,3) = {"
ab
ab
ab
ab
ab
ab
ab
ab
ab
ab
ab
ab
ab
ab
ab
"}
(5,1,3) = {"
ab
ab
ab
ab
ab
ab
ab
ab
ab
ab
ab
ab
ab
ab
ab
"}
(6,1,3) = {"
ab
ab
ab
ab
ab
ab
ab
ab
ab
ab
ab
ab
ab
ab
ab
"}
(7,1,3) = {"
ab
ab
ab
ab
ab
ab
ab
ab
ab
ab
ab
ab
ab
ab
ab
"}
(8,1,3) = {"
ab
ab
ab
ab
ab
ab
ab
ab
ab
ab
ab
ab
ab
ab
ab
"}
(9,1,3) = {"
ab
ab
ab
ab
ab
ab
ab
ab
ab
ab
ab
ab
ab
ab
ab
"}
(10,1,3) = {"
ab
ab
ab
ab
ab
ab
ab
ab
ab
ab
ab
ab
ab
ab
ab
"}
(11,1,3) = {"
ab
ab
ab
ab
ab
ab
ab
ab
ab
ab
ab
ab
ab
ab
ab
"}
(12,1,3) = {"
ab
ab
ab
ab
ab
ab
ab
ab
ab
ab
ab
ab
ab
ab
ab
"}
(13,1,3) = {"
ab
ab
ab
ab
ab
ab
ab
ab
ab
ab
ab
ab
ab
ab
ab
"}
(14,1,3) = {"
ab
ab
ab
ab
ab
ab
ab
ab
ab
ab
ab
ab
ab
ab
ab
"}
(15,1,3) = {"
ab
ab
ab
ab
ab
ab
ab
ab
ab
ab
ab
ab
ab
ab
ab
"}
