//MAP CONVERTED BY dmm2tgm.py THIS HEADER COMMENT PREVENTS RECONVERSION, DO NOT REMOVE
"aa" = (
/turf/template_noop,
/area/template_noop)
"ab" = (
/turf/closed/mineral/random,
/area/ruin/space)
"ac" = (
/turf/open/misc/asteroid/airless,
/area/ruin/space)
"ad" = (
/turf/closed/wall,
/area/ruin/space)
"ae" = (
/turf/closed/wall/rust,
/area/ruin/space)
"af" = (
/obj/item/stack/rods{
	amount = 2
	},
/obj/item/shard,
/turf/open/misc/asteroid/airless,
/area/ruin/space)
"ag" = (
/obj/effect/spawner/structure/window,
/turf/open/floor/plating,
/area/ruin/space)
"ah" = (
/obj/structure/grille/broken,
/obj/structure/barricade/wooden/crude,
/obj/structure/trap/cult,
/obj/effect/decal/cleanable/glass,
/turf/open/floor/plating/airless,
/area/ruin/space)
"ai" = (
/obj/structure/light_prism,
/turf/open/floor/iron/dark/airless,
/area/ruin/space)
"aj" = (
/obj/effect/decal/cleanable/blood/drip,
/turf/open/floor/plating/airless,
/area/ruin/space)
"ak" = (
/obj/item/ectoplasm,
/turf/open/misc/asteroid/airless,
/area/ruin/space)
"al" = (
/obj/structure/closet/crate/coffin,
/turf/open/floor/iron/dark/airless,
/area/ruin/space)
"am" = (
/turf/open/floor/plating/airless,
/area/ruin/space)
"an" = (
/turf/open/floor/carpet/royalblack/airless,
/area/ruin/space)
"ao" = (
/obj/structure/table/wood/fancy,
/obj/item/reagent_containers/cup/glass/bottle/holywater{
	pixel_y = 12
	},
/turf/open/floor/carpet/airless,
/area/ruin/space)
"ap" = (
/obj/structure/table/wood/fancy,
/obj/item/melee/cleric_mace{
	pixel_y = 8
	},
/turf/open/floor/carpet/airless,
/area/ruin/space)
"aq" = (
/obj/effect/decal/cleanable/shreds{
	pixel_x = 5;
	pixel_y = -3
	},
/turf/open/floor/carpet/airless,
/area/ruin/space)
"ar" = (
/obj/effect/decal/cleanable/shreds,
/obj/effect/decal/remains/human,
/obj/item/disk/design_disk/cleric_mace{
	pixel_x = -4;
	pixel_y = 9
	},
/obj/structure/trap/cult,
/turf/open/floor/carpet/airless,
/area/ruin/space)
"as" = (
/obj/effect/decal/cleanable/shreds{
	pixel_y = -4
	},
/turf/open/floor/carpet/royalblack/airless,
/area/ruin/space)
"at" = (
/turf/open/floor/carpet/royalblue/airless,
/area/ruin/space)
"au" = (
/turf/open/floor/carpet/airless,
/area/ruin/space)
"av" = (
/obj/effect/decal/cleanable/blood/splatter,
/obj/effect/decal/cleanable/blood/footprints,
/obj/effect/decal/cleanable/shreds{
	pixel_y = 6;
	pixel_x = -1
	},
/turf/open/floor/carpet/airless,
/area/ruin/space)
"aw" = (
/obj/effect/decal/cleanable/blood/drip,
/turf/open/floor/carpet/royalblack/airless,
/area/ruin/space)
"ax" = (
/obj/structure/bonfire,
/turf/open/floor/iron/dark/airless,
/area/ruin/space)
"ay" = (
/obj/effect/decal/cleanable/blood/tracks,
/turf/open/floor/carpet/airless,
/area/ruin/space)
"az" = (
/obj/item/paper/fluff/ruins/clericsden/contact,
/obj/effect/mapping_helpers/broken_floor,
/turf/open/floor/plating/airless,
/area/ruin/space)
"aA" = (
/obj/structure/table/wood,
/turf/open/floor/carpet/royalblack/airless,
/area/ruin/space)
"aB" = (
/obj/effect/decal/cleanable/blood/footprints,
/obj/effect/decal/cleanable/blood/tracks,
/turf/open/floor/carpet/airless,
/area/ruin/space)
"aC" = (
/obj/structure/chair/wood{
	dir = 1
	},
/turf/open/floor/carpet/royalblue/airless,
/area/ruin/space)
"aD" = (
/obj/effect/decal/remains/human,
/obj/structure/trap/cult,
/turf/open/floor/carpet/airless,
/area/ruin/space)
"aE" = (
/obj/effect/decal/cleanable/blood/tracks,
/mob/living/basic/construct/proteon/hostile,
/turf/open/floor/carpet/airless,
/area/ruin/space)
"aF" = (
/obj/item/paper/fluff/ruins/clericsden/contact,
/turf/open/floor/plating/airless,
/area/ruin/space)
"aG" = (
/obj/effect/decal/cleanable/blood/tracks,
/obj/structure/trap/cult,
/turf/open/floor/carpet/airless,
/area/ruin/space)
"aH" = (
/obj/structure/light_prism,
/turf/open/floor/plating/airless,
/area/ruin/space)
"aI" = (
/obj/effect/decal/cleanable/blood/drip,
/turf/open/floor/carpet/airless,
/area/ruin/space)
"aJ" = (
/obj/structure/rack,
/obj/item/tank/internals/emergency_oxygen,
/obj/item/clothing/mask/breath{
	pixel_y = 6;
	pixel_x = 6
	},
/turf/open/floor/iron/dark/airless,
/area/ruin/space)
"aK" = (
/obj/effect/spawner/structure/window,
/turf/open/floor/plating/airless,
/area/ruin/space)
"aL" = (
/obj/machinery/door/airlock/wood,
/obj/effect/mapping_helpers/broken_floor,
/turf/open/floor/plating/airless,
/area/ruin/space)
"aM" = (
/obj/effect/decal/cleanable/blood/tracks,
/obj/machinery/door/airlock/wood,
/turf/open/floor/plating/airless,
/area/ruin/space)
"aN" = (
/mob/living/basic/construct/proteon,
/turf/open/misc/asteroid/airless,
/area/ruin/space)
"aO" = (
/obj/effect/spawner/structure/window,
/obj/structure/barricade/wooden/crude,
/turf/open/floor/plating/airless,
/area/ruin/space)
"aP" = (
/obj/effect/mapping_helpers/burnt_floor,
/turf/open/floor/plating/airless,
/area/ruin/space)
"aQ" = (
/obj/item/book/bible,
/obj/effect/decal/cleanable/blood,
/turf/open/misc/asteroid/airless,
/area/ruin/space)
"aR" = (
/obj/structure/closet/crate/coffin,
/obj/item/gps/spaceruin,
/turf/open/floor/iron/dark/airless,
/area/ruin/space)
"aS" = (
/obj/effect/decal/cleanable/blood/drip,
/turf/open/misc/asteroid/airless,
/area/ruin/space)
"aT" = (
/obj/structure/table/wood,
/obj/item/flashlight/flare/torch{
	pixel_y = 14
	},
/turf/open/floor/carpet/royalblack/airless,
/area/ruin/space)
"aU" = (
/obj/effect/decal/remains/human,
/obj/item/paper/fluff/ruins/clericsden/warning,
/turf/open/misc/asteroid/airless,
/area/ruin/space)
"aV" = (
/obj/effect/decal/cleanable/blood/splatter,
/obj/effect/decal/cleanable/blood/footprints,
/obj/effect/decal/cleanable/shreds,
/turf/open/floor/carpet/airless,
/area/ruin/space)
"aW" = (
/obj/structure/rack,
/obj/item/tank/internals/emergency_oxygen,
/obj/item/clothing/mask/breath,
/turf/open/floor/iron/dark/airless,
/area/ruin/space)
"aX" = (
/obj/item/flashlight/flare/torch,
/turf/open/floor/plating/airless,
/area/ruin/space)
"aY" = (
/obj/effect/mapping_helpers/broken_floor,
/turf/open/floor/plating/airless,
/area/ruin/space)
"aZ" = (
/obj/machinery/door/airlock/wood,
/turf/open/floor/plating/airless,
/area/ruin/space)
"hO" = (
/obj/structure/table/wood/fancy,
/obj/item/melee/cleric_mace,
/turf/open/floor/carpet/airless,
/area/ruin/space)
"DB" = (
/obj/effect/decal/cleanable/shreds,
/turf/open/floor/carpet/royalblack/airless,
/area/ruin/space)
"Jj" = (
/obj/effect/decal/cleanable/shreds,
/turf/open/floor/carpet/airless,
/area/ruin/space)
"Mg" = (
/obj/structure/table/wood/fancy,
/obj/item/reagent_containers/cup/glass/bottle/holywater,
/turf/open/floor/carpet/airless,
/area/ruin/space)
"RE" = (
/obj/effect/decal/cleanable/shreds,
/obj/effect/decal/remains/human,
/obj/item/disk/design_disk/cleric_mace,
/obj/structure/trap/cult,
/turf/open/floor/carpet/airless,
/area/ruin/space)

(1,1,1) = {"
aa
aa
aa
aa
aa
aa
aa
aa
ac
ab
ac
ac
ac
ac
aa
aa
aa
aa
"}
(2,1,1) = {"
aa
aa
aa
ac
ac
ac
ac
ac
ac
ac
ac
ab
ac
ac
ab
ac
ac
aa
"}
(3,1,1) = {"
aa
ac
ab
ac
ac
ab
ac
ab
ac
ac
ab
ab
ab
ac
ab
ab
ab
aa
"}
(4,1,1) = {"
aa
ab
ab
ab
ab
ab
ab
ab
ab
ab
ab
ab
ab
ab
ab
ab
ac
aa
"}
(5,1,1) = {"
aa
ab
ad
ad
ae
ad
ae
aK
ad
ad
ad
ad
ad
ad
ae
ac
ac
aa
"}
(6,1,1) = {"
aa
ab
ae
ai
aR
ae
ax
am
ae
ax
am
ae
am
aW
ad
ae
ab
aa
"}
(7,1,1) = {"
aa
aa
ae
aj
an
an
at
aw
aA
aC
an
aA
aC
an
aH
ae
ad
aa
"}
(8,1,1) = {"
aa
af
ah
am
Mg
Jj
au
au
au
aD
au
au
au
au
aI
aZ
ac
ac
"}
(9,1,1) = {"
aa
ab
ag
am
hO
RE
aV
ay
aB
aE
aB
ay
aB
aG
aB
aM
aU
aS
"}
(10,1,1) = {"
aa
ab
ad
am
an
DB
at
an
aA
aC
an
aA
aC
an
aH
ad
ae
ac
"}
(11,1,1) = {"
aa
ac
ae
ai
al
ad
ax
aF
ae
ax
aX
ae
am
aW
ae
ad
ab
ab
"}
(12,1,1) = {"
aa
aa
ae
ae
ad
ad
ae
aO
ad
ad
ad
ae
ae
ad
ad
ab
ab
ac
"}
(13,1,1) = {"
aa
ab
ab
ab
ab
ab
ab
ab
ab
ab
ab
ab
ab
ab
ab
ab
ac
ac
"}
(14,1,1) = {"
aa
ac
ab
ab
ab
ac
ab
ab
ac
ab
ac
aQ
ab
ab
ab
ac
aS
aa
"}
(15,1,1) = {"
aa
aa
ac
ac
ac
ac
ac
ac
aN
ac
ac
ac
ac
aS
ac
ac
aa
aa
"}
(16,1,1) = {"
aa
aa
ak
ac
ab
ab
ac
ac
ab
ac
ac
ab
ac
ab
ab
ab
aa
aa
"}
(17,1,1) = {"
aa
ab
ac
ab
ac
ab
ab
ab
ab
ab
ab
ab
ab
ab
ac
aa
aa
aa
"}
(18,1,1) = {"
ab
ab
ab
aa
aa
ac
ac
ac
ac
ac
ac
ac
ac
aa
aa
aa
aa
aa
"}
(19,1,1) = {"
aa
ab
aa
aa
aa
aa
aa
aa
aa
aa
aa
aa
aa
aa
aa
aa
aa
aa
"}
