"a" = (/turf/open/floor/iron/white,/area/shuttle/escape)
"b" = (/obj/machinery/door/airlock/shuttle{name = "Left Engine Maintenance"},/obj/machinery/atmospherics/pipe/smart/manifold4w/supply/hidden/layer4,/turf/open/floor/plating,/area/shuttle/escape)
"c" = (/obj/machinery/door/airlock/command{name = "Pilot's Quarters"},/obj/machinery/atmospherics/pipe/smart/manifold4w/supply/hidden/layer4,/turf/open/floor/iron/white,/area/shuttle/escape)
"d" = (/obj/machinery/mass_driver{id = "medevacr"},/obj/machinery/atmospherics/pipe/smart/manifold4w/supply/hidden/layer4,/turf/open/floor/plating,/area/shuttle/escape)
"e" = (/obj/effect/spawner/structure/window/reinforced/shuttle,/turf/open/floor/plating,/area/shuttle/escape)
"f" = (/obj/machinery/atmospherics/pipe/smart/manifold4w/supply/hidden/layer4,/turf/open/floor/plating,/area/shuttle/escape)
"g" = (/turf/open/floor/iron/dark,/area/shuttle/escape/brig)
"h" = (/turf/closed/wall/mineral/titanium,/area/shuttle/escape)
"i" = (/obj/machinery/atmospherics/components/unary/vent_pump/on/layer4{dir = 4},/turf/open/floor/iron/dark,/area/shuttle/escape/brig)
"j" = (/turf/template_noop,/area/template_noop)
"k" = (/obj/machinery/mass_driver{id = "medevacl"},/obj/machinery/atmospherics/pipe/smart/manifold4w/supply/hidden/layer4,/turf/open/floor/plating,/area/shuttle/escape)
"l" = (/obj/machinery/atmospherics/components/unary/vent_pump/on/layer4{dir = 4},/turf/open/floor/plating,/area/shuttle/escape)
"m" = (/obj/machinery/door/airlock/medical/glass{name = "Hospital Atrium"},/obj/machinery/atmospherics/pipe/smart/manifold4w/supply/hidden/layer4,/turf/open/floor/iron/white,/area/shuttle/escape)
"n" = (/obj/machinery/door/airlock/medical/glass{name = "Hospital Storage"},/turf/open/floor/iron/white,/area/shuttle/escape)
"o" = (/obj/machinery/door/airlock/medical/glass{name = "Treatment Room A"},/obj/machinery/atmospherics/pipe/smart/manifold4w/supply/hidden/layer4,/turf/open/floor/iron/white,/area/shuttle/escape)
"p" = (/turf/open/floor/plating,/area/shuttle/escape)
"q" = (/obj/machinery/door/airlock/medical/glass{name = "Treatment Room B"},/obj/machinery/atmospherics/pipe/smart/manifold4w/supply/hidden/layer4,/turf/open/floor/iron/white,/area/shuttle/escape)
"r" = (/obj/machinery/atmospherics/components/unary/vent_pump/on/layer4{dir = 4},/turf/open/floor/iron/white,/area/shuttle/escape)
"s" = (/obj/machinery/door/airlock/security/glass{name = "Holding Area"},/obj/machinery/atmospherics/pipe/smart/manifold4w/supply/hidden/layer4,/turf/open/floor/iron/dark,/area/shuttle/escape/brig)
"t" = (/obj/machinery/door/airlock/medical/glass{name = "Treatment Room C"},/obj/machinery/atmospherics/pipe/smart/manifold4w/supply/hidden/layer4,/turf/open/floor/iron/white,/area/shuttle/escape)
"v" = (/obj/machinery/atmospherics/pipe/smart/manifold4w/supply/hidden/layer4,/turf/open/floor/iron/dark,/area/shuttle/escape/brig)
"w" = (/turf/closed/wall/mineral/titanium/nodiagonal,/area/shuttle/escape/brig)
"x" = (/obj/structure/window/reinforced/shuttle,/turf/open/floor/grass,/area/shuttle/escape)
"y" = (/obj/machinery/door/poddoor{id = "medevacl"},/turf/open/floor/plating,/area/shuttle/escape)
"z" = (/obj/machinery/atmospherics/components/unary/vent_pump/on/layer4{dir = 8},/turf/open/floor/iron/white,/area/shuttle/escape)
"A" = (/obj/machinery/door/airlock/command/glass{name = "Cockpit"},/turf/open/floor/iron/white,/area/shuttle/escape)
"C" = (/obj/machinery/atmospherics/pipe/smart/manifold4w/supply/hidden/layer4,/turf/open/floor/iron/white,/area/shuttle/escape)
"D" = (/obj/machinery/door/airlock/medical/glass{name = "Treatment Room E"},/obj/machinery/atmospherics/pipe/smart/manifold4w/supply/hidden/layer4,/turf/open/floor/iron/white,/area/shuttle/escape)
"E" = (/obj/machinery/door/airlock/medical/glass{name = "Treatment Room D"},/obj/machinery/atmospherics/pipe/smart/manifold4w/supply/hidden/layer4,/turf/open/floor/iron/white,/area/shuttle/escape)
"F" = (/obj/machinery/atmospherics/components/unary/vent_pump/on/layer4,/turf/open/floor/iron/white,/area/shuttle/escape)
"G" = (/obj/machinery/atmospherics/components/unary/vent_pump/on/layer4{dir = 1},/turf/open/floor/iron/white,/area/shuttle/escape)
"H" = (/obj/machinery/power/shuttle_engine/propulsion,/obj/effect/turf_decal/stripes/line,/turf/open/floor/plating/airless,/area/shuttle/escape)
"I" = (/obj/machinery/door/airlock/mining/glass{name = "Cargo Hold"},/obj/machinery/atmospherics/pipe/smart/manifold4w/supply/hidden/layer4,/turf/open/floor/iron/white,/area/shuttle/escape)
"J" = (/obj/machinery/door/airlock/shuttle{name = "Emergency Shuttle Airlock"},/turf/open/floor/iron/white,/area/shuttle/escape)
"K" = (/obj/machinery/atmospherics/components/unary/vent_pump/on/layer4{dir = 8},/turf/open/floor/plating,/area/shuttle/escape)
"L" = (/turf/closed/wall/mineral/plastitanium,/area/shuttle/escape)
"M" = (/obj/machinery/door/airlock/medical/glass{name = "Hospital Storage"},/obj/machinery/atmospherics/pipe/smart/manifold4w/supply/hidden/layer4,/turf/open/floor/iron/white,/area/shuttle/escape)
"N" = (/obj/machinery/door/airlock/medical/glass{name = "Treatment Centre Corridor"},/turf/open/floor/iron/white,/area/shuttle/escape)
"O" = (/obj/machinery/door/poddoor{id = "medevacr"},/turf/open/floor/plating,/area/shuttle/escape)
"P" = (/obj/machinery/door/airlock/shuttle{name = "Emergency Shuttle Airlock"},/obj/docking_port/mobile/emergency{name = "Medical Evacuation Shuttle"},/turf/open/floor/iron/white,/area/shuttle/escape)
"Q" = (/obj/machinery/door/airlock/medical/glass{name = "Treatment Room F"},/obj/structure/barricade/wooden/crude,/obj/machinery/atmospherics/pipe/smart/manifold4w/supply/hidden/layer4,/turf/open/floor/iron/white,/area/shuttle/escape)
"R" = (/obj/machinery/door/airlock/command/glass{name = "Cockpit"},/obj/machinery/atmospherics/pipe/smart/manifold4w/supply/hidden/layer4,/turf/open/floor/iron/white,/area/shuttle/escape)
"S" = (/obj/machinery/door/airlock/medical/glass{name = "Treatment Centre Corridor"},/obj/machinery/atmospherics/pipe/smart/manifold4w/supply/hidden/layer4,/turf/open/floor/iron/white,/area/shuttle/escape)
"U" = (/obj/machinery/door/airlock/command{name = "Copilot's Quarters"},/obj/machinery/atmospherics/pipe/smart/manifold4w/supply/hidden/layer4,/turf/open/floor/iron/white,/area/shuttle/escape)
"V" = (/obj/machinery/atmospherics/components/unary/vent_pump/on/layer4{dir = 1},/turf/open/floor/plating,/area/shuttle/escape)
"W" = (/obj/machinery/door/airlock/glass_large{name = "Custodial Closet"},/obj/machinery/atmospherics/pipe/smart/manifold4w/supply/hidden/layer4,/turf/open/floor/iron/white,/area/shuttle/escape)
"X" = (/obj/machinery/door/airlock/medical/glass{name = "Hospital Atrium"},/turf/open/floor/iron/white,/area/shuttle/escape)
"Y" = (/obj/machinery/door/airlock/shuttle{name = "Right Engine Maintenance"},/obj/machinery/atmospherics/pipe/smart/manifold4w/supply/hidden/layer4,/turf/open/floor/plating,/area/shuttle/escape)
"Z" = (/obj/machinery/power/shuttle_engine/heater,/obj/effect/turf_decal/stripes/line,/obj/structure/window/reinforced/spawner/directional/north,/turf/open/floor/plating/airless,/area/shuttle/escape)

(1,1,1) = {"
jjjjjjjhhehheeeeeehhehhjjjjjjj
jjjjjjhhaaahrCCaaahaaahhjjjjjj
jjjjjhahaaahaaCaaahaaahahjjjjj
jjjjhaahaaahaaCaaahaaahaahjjjj
jjjhaaahrCCcCCCCCCUCCzhaaahjjj
jjhaaaahhhhhhhRAhhhhhhhaaaahjj
jhrCCaahaaaaaaCaaaaaaahaaCCzhj
hhhhIhhhaaaaaaCaaaaaaahhhIhhhh
eaaaCCCCCCCCCCCCCCCCCCCCCCaaae
eaaaaaaaaCaaaaaaaaaaaaCaaaaaae
hhhhhhhhhCaaaaaaaaaaahSNhhhhhh
haaaaaaahCaaaaaaaaaaahCahFaaah
JaaaaaaaXCahhhhhhhhaahCCoCaaae
PaaaaaaaXCahaaaaaahaahCahaaaah
haaahaaahCanaaaaaanaahCahhhhhh
eaaaxaaahCahaaaaaahaahCahFaaah
eaaahaaaxCahaaaaaahaahCCqCaaae
eaaaaaaaxCahaaaaaahaahCahaaaah
haaaaaaaxCahaaaaaahaahCahhhhhh
eaaaaaaaxCahaaaaaahaahCahFaaah
eaaahaaaxCahaaaaaahaahCCtCaaae
eaaaxaaahCahaaaaaahaahCahaaaah
haaahaaahCCMCaaaaanaahCahhhhhh
JaaaFaaaXCahGaaaaahaahCahFaaah
JaCCCCCCmCahhhhhhhhaahCCECaaae
haCaaaaahCahaaaaaahaahCahaaaah
hhshhhhhhCaeaaaaaaeaahCahhhhhh
hivggggghCahrCCaaahaahCahFaaah
hggggggghCahhhWahhhaahCCDCaaae
eggggggghCaFaaCaaaaaaNCahaaaah
egggwggghCCCCCCCCCCCCSCahhhhhh
eggggggghhhhhhCahhhhhhCahFaaah
hggggggghaaaFaCaaaaaahCCQCaaae
hggggggghCCCCCCCCCCCChGahaaaah
hhhhhhhhhbhhCaaaaChhYhhhhhhhhh
jjhpffffffKhkaaaadhlffffffphjj
jjhpppppppphVaaaaVhpppppppphjj
jjhpppppppphyheehOhpppppppphjj
jjLZZZZZZZZLjjjjjjLZZZZZZZZLjj
jjLHHHHHHHHLjjjjjjLHHHHHHHHLjj
"}
