//MAP CONVERTED BY dmm2tgm.py THIS HEADER COMMENT PREVENTS RECONVERSION, DO NOT REMOVE
"ax" = (
/obj/effect/turf_decal/siding/white{
	dir = 9
	},
/turf/open/floor/iron/white/small{
	name = "padded floor"
	},
/area/shuttle/escape/brig)
"aD" = (
/obj/effect/turf_decal/siding/white{
	dir = 5
	},
/turf/open/floor/iron/white/small{
	name = "padded floor"
	},
/area/shuttle/escape/brig)
"aO" = (
/obj/effect/turf_decal/siding/blue/corner{
	dir = 8
	},
/turf/open/floor/iron/white,
/area/shuttle/escape/brig)
"aU" = (
/obj/effect/turf_decal/siding/white{
	dir = 10
	},
/turf/open/floor/iron/white/small{
	name = "padded floor"
	},
/area/shuttle/escape/brig)
"bU" = (
/obj/machinery/door/airlock/medical/glass{
	name = "Hospital Storage"
	},
/obj/effect/mapping_helpers/airlock/access/any/medical/general,
/turf/open/floor/iron/white,
/area/shuttle/escape)
"eR" = (
/obj/effect/turf_decal/siding/white{
	dir = 1
	},
/turf/open/floor/iron/white/small{
	name = "padded floor"
	},
/area/shuttle/escape/brig)
"eY" = (
/obj/machinery/power/shuttle_engine/propulsion,
/obj/effect/turf_decal/stripes/line,
/turf/open/floor/plating/airless,
/area/shuttle/escape)
"fr" = (
/obj/machinery/door/airlock/medical{
	name = "Padded Cell"
	},
/obj/effect/mapping_helpers/airlock/access/any/medical/general,
/turf/open/floor/iron/white/small{
	name = "padded floor"
	},
/area/shuttle/escape/brig)
"gh" = (
/obj/structure/window/reinforced/shuttle,
/turf/open/floor/grass,
/area/shuttle/escape)
"gm" = (
/obj/effect/turf_decal/siding/white{
	dir = 4
	},
/turf/open/floor/iron/white/small{
	name = "padded floor"
	},
/area/shuttle/escape/brig)
"gE" = (
/turf/template_noop,
/area/template_noop)
"ig" = (
/obj/machinery/door/airlock/shuttle{
	name = "Right Engine Maintenance"
	},
/obj/effect/mapping_helpers/airlock/access/any/engineering/general,
/turf/open/floor/plating,
/area/shuttle/escape)
"ir" = (
/obj/machinery/door/airlock/command/glass{
	name = "Cockpit"
	},
/obj/effect/mapping_helpers/airlock/access/any/command/general,
/turf/open/floor/iron/white,
/area/shuttle/escape)
"jj" = (
/obj/machinery/door/airlock/mining/glass{
	name = "Cargo Hold"
	},
/turf/open/floor/iron/white,
/area/shuttle/escape)
"jt" = (
/obj/structure/sign/warning/vacuum/external{
	pixel_x = -31
	},
/turf/open/floor/iron/white,
/area/shuttle/escape)
"jW" = (
/obj/machinery/door/airlock/security/glass{
	name = "Security Checkpoint"
	},
/obj/effect/mapping_helpers/airlock/access/any/security/general,
/turf/open/floor/iron/dark,
/area/shuttle/escape/brig)
"kl" = (
/obj/machinery/door/window/left/directional/east{
	icon_state = "right";
	name = "Right Mass Driver"
	},
/turf/open/floor/iron/white,
/area/shuttle/escape)
"kI" = (
/obj/machinery/door/airlock/medical/glass{
	name = "Hospital Atrium"
	},
/turf/open/floor/iron/white,
/area/shuttle/escape)
"lM" = (
/obj/machinery/power/shuttle_engine/heater,
/obj/effect/turf_decal/stripes/line,
/obj/structure/window/reinforced/spawner/directional/north,
/turf/open/floor/plating/airless,
/area/shuttle/escape)
"mX" = (
/obj/machinery/door/airlock/medical/glass{
	name = "Treatment Room D"
	},
/obj/effect/mapping_helpers/airlock/access/any/medical/surgery,
/turf/open/floor/iron/white,
/area/shuttle/escape)
"nt" = (
/obj/item/kirbyplants/organic/plant6,
/turf/open/floor/iron/white,
/area/shuttle/escape)
"nV" = (
/obj/structure/sign/warning/vacuum/external,
/turf/closed/wall/mineral/titanium/nodiagonal,
/area/shuttle/escape)
"qH" = (
/turf/closed/wall/mineral/silver{
	name = "padded wall"
	},
/area/shuttle/escape/brig)
"qS" = (
/obj/structure/chair,
/turf/open/floor/iron/white,
/area/shuttle/escape)
"rC" = (
/obj/machinery/door/airlock/command{
	name = "Copilot's Quarters"
	},
/obj/effect/mapping_helpers/airlock/access/any/command/general,
/turf/open/floor/iron/white,
/area/shuttle/escape)
"sv" = (
/obj/effect/turf_decal/siding/red{
	dir = 4
	},
/turf/open/floor/iron/dark,
/area/shuttle/escape/brig)
"sQ" = (
/obj/effect/turf_decal/siding/red/corner,
/turf/open/floor/iron/dark,
/area/shuttle/escape/brig)
"tH" = (
/obj/effect/turf_decal/siding/red/corner{
	dir = 4
	},
/turf/open/floor/iron/dark,
/area/shuttle/escape/brig)
"ve" = (
/obj/machinery/door/airlock/medical/glass{
	name = "Treatment Room B"
	},
/obj/effect/mapping_helpers/airlock/access/any/medical/surgery,
/turf/open/floor/iron/white,
/area/shuttle/escape)
"vS" = (
/obj/machinery/door/airlock/medical/glass{
	name = "Treatment Room E"
	},
/obj/effect/mapping_helpers/airlock/access/any/medical/surgery,
/turf/open/floor/iron/white,
/area/shuttle/escape)
"wc" = (
/obj/structure/window/reinforced/spawner/directional/east,
/obj/machinery/computer/pod/old/mass_driver_controller{
	pixel_y = -24;
	id = "medevacr"
	},
/turf/open/floor/iron/white,
/area/shuttle/escape)
"wi" = (
/obj/machinery/door/window/left/directional/south{
	name = "Hospital Funeral Access"
	},
/turf/open/floor/iron/white,
/area/shuttle/escape)
"wC" = (
/obj/structure/window/reinforced/spawner/directional/west,
/obj/machinery/computer/pod/old/mass_driver_controller{
	pixel_y = -24;
	id = "medevacl"
	},
/turf/open/floor/iron/white,
/area/shuttle/escape)
"zm" = (
/turf/closed/wall/mineral/titanium,
/area/shuttle/escape)
"Au" = (
/obj/machinery/door/airlock/command{
	name = "Pilot's Quarters"
	},
/obj/effect/mapping_helpers/airlock/access/any/command/general,
/turf/open/floor/iron/white,
/area/shuttle/escape)
"AC" = (
/obj/structure/chair/sofa/bench,
/turf/open/floor/iron/white,
/area/shuttle/escape)
"Bc" = (
/obj/machinery/door/airlock/medical/glass{
	name = "Treatment Centre Corridor"
	},
/obj/effect/mapping_helpers/airlock/access/any/medical/general,
/obj/effect/mapping_helpers/airlock/unres{
	dir = 4
	},
/turf/open/floor/iron/white,
/area/shuttle/escape)
"Bq" = (
/obj/machinery/door/airlock/shuttle{
	name = "Left Engine Maintenance"
	},
/obj/effect/mapping_helpers/airlock/access/any/engineering/general,
/turf/open/floor/plating,
/area/shuttle/escape)
"BD" = (
/obj/machinery/mass_driver{
	id = "medevacr"
	},
/turf/open/floor/plating,
/area/shuttle/escape)
"Ce" = (
/obj/effect/turf_decal/siding/blue{
	dir = 8
	},
/obj/effect/turf_decal/siding/blue/corner,
/turf/open/floor/iron/white,
/area/shuttle/escape/brig)
"EA" = (
/obj/effect/turf_decal/siding/white,
/turf/open/floor/iron/white/small{
	name = "padded floor"
	},
/area/shuttle/escape/brig)
"EQ" = (
/obj/effect/spawner/structure/window/reinforced/shuttle,
/turf/open/floor/plating,
/area/shuttle/escape)
"ER" = (
/obj/machinery/door/airlock/medical/glass{
	name = "Treatment Room A"
	},
/obj/effect/mapping_helpers/airlock/access/any/medical/surgery,
/turf/open/floor/iron/white,
/area/shuttle/escape)
"FB" = (
/obj/machinery/door/airlock/glass_large{
	name = "Custodial Closet"
	},
/obj/effect/mapping_helpers/airlock/access/any/service/janitor,
/turf/open/floor/iron/white,
/area/shuttle/escape)
"FN" = (
/turf/open/floor/iron/white,
/area/shuttle/escape/brig)
"GD" = (
/obj/structure/chair/sofa/bench/left,
/turf/open/floor/iron/white,
/area/shuttle/escape)
"GK" = (
/obj/machinery/door/airlock/shuttle{
	name = "Emergency Shuttle Airlock"
	},
/turf/open/floor/iron/white,
/area/shuttle/escape)
"HN" = (
/obj/machinery/door/poddoor{
	id = "medevacl"
	},
/turf/open/floor/plating,
/area/shuttle/escape)
"Ic" = (
/obj/machinery/door/airlock/shuttle{
	name = "Emergency Shuttle Airlock"
	},
/obj/docking_port/mobile/emergency{
	name = "Medical Evacuation Shuttle"
	},
/turf/open/floor/iron/white,
/area/shuttle/escape)
"Ke" = (
/obj/machinery/door/airlock/medical{
	name = "Psych Ward"
	},
/obj/effect/mapping_helpers/airlock/access/any/medical/general,
/turf/open/floor/iron/white,
/area/shuttle/escape/brig)
"Kz" = (
/turf/open/floor/iron/dark,
/area/shuttle/escape/brig)
"KT" = (
/obj/effect/turf_decal/siding/white{
	dir = 6
	},
/turf/open/floor/iron/white/small{
	name = "padded floor"
	},
/area/shuttle/escape/brig)
"LG" = (
/obj/machinery/door/airlock/medical/glass{
	name = "Treatment Room C"
	},
/obj/effect/mapping_helpers/airlock/access/any/medical/surgery,
/turf/open/floor/iron/white,
/area/shuttle/escape)
"LI" = (
/obj/machinery/door/airlock/medical/glass{
	name = "Treatment Room F"
	},
/obj/structure/barricade/wooden/crude,
/obj/effect/mapping_helpers/airlock/locked,
/obj/effect/mapping_helpers/airlock/access/any/medical/surgery,
/turf/open/floor/iron/white,
/area/shuttle/escape)
"Nq" = (
/obj/machinery/door/window{
	name = "Hospital Funeral Access";
	dir = 2;
	icon_state = "right"
	},
/turf/open/floor/iron/white,
/area/shuttle/escape)
"Nt" = (
/turf/closed/wall/mineral/plastitanium,
/area/shuttle/escape)
"On" = (
/obj/machinery/mass_driver{
	id = "medevacl"
	},
/turf/open/floor/plating,
/area/shuttle/escape)
"Op" = (
/obj/machinery/door/airlock/medical/glass{
	name = "Treatment Centre Corridor"
	},
/obj/effect/mapping_helpers/airlock/access/any/medical/general,
/obj/effect/mapping_helpers/airlock/unres,
/turf/open/floor/iron/white,
/area/shuttle/escape)
"Os" = (
/obj/machinery/door/window/left/directional/west{
	name = "Left Mass Driver"
	},
/turf/open/floor/iron/white,
/area/shuttle/escape)
"QJ" = (
/obj/structure/window/reinforced/spawner/directional/south,
/turf/open/floor/iron/white,
/area/shuttle/escape)
"RO" = (
/obj/structure/fans/tiny,
/turf/open/floor/plating,
/area/shuttle/escape)
"RS" = (
/obj/effect/turf_decal/siding/blue{
	dir = 8
	},
/turf/open/floor/iron/white,
/area/shuttle/escape/brig)
"RT" = (
/obj/effect/turf_decal/siding/white{
	dir = 8
	},
/turf/open/floor/iron/white/small{
	name = "padded floor"
	},
/area/shuttle/escape/brig)
"Tb" = (
/obj/effect/turf_decal/siding/blue,
/turf/open/floor/iron/white,
/area/shuttle/escape/brig)
"Uf" = (
/turf/open/floor/iron/white,
/area/shuttle/escape)
"Vo" = (
/obj/machinery/door/poddoor{
	id = "medevacr"
	},
/turf/open/floor/plating,
/area/shuttle/escape)
"Wa" = (
/obj/structure/chair/sofa/bench/right,
/turf/open/floor/iron/white,
/area/shuttle/escape)
"Wn" = (
/turf/open/floor/plating,
/area/shuttle/escape)
"WQ" = (
/obj/machinery/door/airlock/medical{
	name = "Padded Cell"
	},
/obj/effect/mapping_helpers/airlock/access/any/security/general,
/turf/open/floor/iron/white/small{
	name = "padded floor"
	},
/area/shuttle/escape/brig)
"ZP" = (
/turf/open/floor/iron/white/small{
	name = "padded floor"
	},
/area/shuttle/escape/brig)

(1,1,1) = {"
gE
gE
gE
gE
gE
gE
gE
zm
EQ
EQ
zm
zm
GK
Ic
zm
EQ
EQ
EQ
zm
EQ
EQ
EQ
zm
GK
GK
zm
zm
zm
zm
EQ
EQ
EQ
zm
zm
zm
gE
gE
gE
gE
gE
"}
(2,1,1) = {"
gE
gE
gE
gE
gE
gE
zm
zm
Uf
Uf
zm
Uf
Uf
Uf
jt
Uf
Uf
Uf
Uf
Uf
Uf
Uf
jt
Uf
Uf
Uf
zm
Kz
Kz
Kz
Kz
Kz
Kz
Kz
zm
gE
gE
gE
gE
gE
"}
(3,1,1) = {"
gE
gE
gE
gE
gE
zm
Uf
zm
Uf
Uf
zm
Uf
Uf
Uf
Uf
Uf
Uf
Uf
Uf
Uf
Uf
Uf
Uf
Uf
Uf
Uf
jW
Kz
Kz
Kz
sQ
sv
tH
Kz
zm
zm
zm
zm
Nt
Nt
"}
(4,1,1) = {"
gE
gE
gE
gE
zm
Uf
Uf
zm
Uf
Uf
zm
Uf
Uf
Uf
Uf
Uf
Uf
Uf
Uf
Uf
Uf
Uf
Uf
Uf
Uf
Uf
zm
sv
sv
qH
qH
WQ
qH
qH
zm
Wn
Wn
Wn
lM
eY
"}
(5,1,1) = {"
gE
gE
gE
zm
Uf
Uf
Uf
jj
Uf
Uf
zm
Uf
Uf
Uf
zm
gh
zm
Uf
Uf
Uf
zm
gh
zm
Uf
Uf
Uf
zm
RS
Ce
qH
ax
RT
aU
qH
zm
Wn
Wn
Wn
lM
eY
"}
(6,1,1) = {"
gE
gE
zm
Uf
Uf
Uf
Uf
zm
Uf
Uf
zm
Uf
Uf
Uf
Uf
Uf
Uf
Uf
Uf
Uf
Uf
Uf
Uf
Uf
Uf
Uf
zm
FN
Tb
fr
eR
ZP
EA
qH
zm
Wn
Wn
Wn
lM
eY
"}
(7,1,1) = {"
gE
zm
Uf
Uf
Uf
Uf
Uf
zm
Uf
Uf
zm
Uf
Uf
Uf
Uf
Uf
Uf
Uf
Uf
Uf
Uf
Uf
Uf
Uf
Uf
Uf
zm
FN
aO
qH
aD
gm
KT
qH
zm
Wn
Wn
Wn
lM
eY
"}
(8,1,1) = {"
zm
zm
zm
zm
zm
zm
zm
zm
Uf
Uf
zm
Uf
Uf
Uf
Uf
Uf
Uf
Uf
Uf
Uf
Uf
Uf
Uf
Uf
Uf
Uf
zm
FN
FN
qH
qH
qH
qH
qH
zm
Wn
Wn
Wn
lM
eY
"}
(9,1,1) = {"
zm
Uf
Uf
Uf
Uf
zm
Uf
Uf
Uf
Uf
zm
zm
kI
kI
zm
zm
gh
gh
gh
gh
gh
zm
zm
kI
kI
zm
zm
zm
Ke
zm
zm
zm
zm
zm
zm
Wn
Wn
Wn
lM
eY
"}
(10,1,1) = {"
EQ
Uf
Uf
Uf
Uf
zm
Uf
Uf
Uf
Uf
Uf
Uf
Uf
Uf
Uf
Uf
Uf
Uf
Uf
Uf
Uf
Uf
Uf
Uf
Uf
Uf
Uf
Uf
Uf
Uf
Uf
zm
nt
Uf
Bq
Wn
Wn
Wn
lM
eY
"}
(11,1,1) = {"
zm
Uf
Uf
Uf
Uf
zm
Uf
Uf
Uf
Uf
Uf
Uf
Uf
Uf
Uf
Uf
Uf
Uf
Uf
Uf
Uf
Uf
Uf
Uf
Uf
Uf
Uf
Uf
Uf
Uf
Uf
zm
Wa
Uf
zm
Wn
Wn
Wn
lM
eY
"}
(12,1,1) = {"
zm
zm
zm
zm
Au
zm
Uf
Uf
Uf
Uf
Uf
Uf
zm
zm
bU
zm
zm
zm
zm
zm
zm
zm
bU
zm
zm
zm
EQ
zm
zm
Uf
Uf
zm
AC
Uf
zm
zm
zm
zm
Nt
Nt
"}
(13,1,1) = {"
EQ
Uf
Uf
Uf
Uf
zm
Uf
Uf
Uf
Uf
Uf
Uf
zm
Uf
Uf
Uf
Uf
Uf
Uf
Uf
Uf
Uf
Uf
Uf
zm
Uf
Uf
Uf
zm
Uf
Uf
zm
GD
Uf
nV
On
RO
HN
gE
gE
"}
(14,1,1) = {"
EQ
Uf
Uf
Uf
Uf
zm
Uf
Uf
Uf
Uf
Uf
Uf
zm
Uf
Uf
Uf
Uf
Uf
Uf
Uf
Uf
Uf
Uf
Uf
zm
Uf
Uf
Uf
zm
Uf
Uf
zm
nt
Uf
QJ
Os
wC
zm
gE
gE
"}
(15,1,1) = {"
EQ
Uf
Uf
Uf
Uf
ir
Uf
Uf
Uf
Uf
Uf
Uf
zm
Uf
Uf
Uf
Uf
Uf
Uf
Uf
Uf
Uf
Uf
Uf
zm
Uf
Uf
Uf
FB
Uf
Uf
Uf
Uf
Uf
wi
Uf
qS
EQ
gE
gE
"}
(16,1,1) = {"
EQ
Uf
Uf
Uf
Uf
ir
Uf
Uf
Uf
Uf
Uf
Uf
zm
Uf
Uf
Uf
Uf
Uf
Uf
Uf
Uf
Uf
Uf
Uf
zm
Uf
Uf
Uf
Uf
Uf
Uf
Uf
Uf
Uf
Nq
Uf
qS
EQ
gE
gE
"}
(17,1,1) = {"
EQ
Uf
Uf
Uf
Uf
zm
Uf
Uf
Uf
Uf
Uf
Uf
zm
Uf
Uf
Uf
Uf
Uf
Uf
Uf
Uf
Uf
Uf
Uf
zm
Uf
Uf
Uf
zm
Uf
Uf
zm
nt
Uf
QJ
kl
wc
zm
gE
gE
"}
(18,1,1) = {"
EQ
Uf
Uf
Uf
Uf
zm
Uf
Uf
Uf
Uf
Uf
Uf
zm
Uf
Uf
Uf
Uf
Uf
Uf
Uf
Uf
Uf
Uf
Uf
zm
Uf
Uf
Uf
zm
Uf
Uf
zm
Wa
Uf
nV
BD
RO
Vo
gE
gE
"}
(19,1,1) = {"
zm
zm
zm
zm
rC
zm
Uf
Uf
Uf
Uf
Uf
Uf
zm
zm
bU
zm
zm
zm
zm
zm
zm
zm
bU
zm
zm
zm
EQ
zm
zm
Uf
Uf
zm
AC
Uf
zm
zm
zm
zm
Nt
Nt
"}
(20,1,1) = {"
zm
Uf
Uf
Uf
Uf
zm
Uf
Uf
Uf
Uf
Uf
Uf
Uf
Uf
Uf
Uf
Uf
Uf
Uf
Uf
Uf
Uf
Uf
Uf
Uf
Uf
Uf
Uf
Uf
Uf
Uf
zm
GD
Uf
zm
Wn
Wn
Wn
lM
eY
"}
(21,1,1) = {"
EQ
Uf
Uf
Uf
Uf
zm
Uf
Uf
Uf
Uf
Uf
Uf
Uf
Uf
Uf
Uf
Uf
Uf
Uf
Uf
Uf
Uf
Uf
Uf
Uf
Uf
Uf
Uf
Uf
Uf
Uf
zm
nt
Uf
ig
Wn
Wn
Wn
lM
eY
"}
(22,1,1) = {"
zm
Uf
Uf
Uf
Uf
zm
Uf
Uf
Uf
Uf
zm
zm
zm
zm
zm
zm
zm
zm
zm
zm
zm
zm
zm
zm
zm
zm
zm
zm
zm
Bc
Bc
zm
zm
zm
zm
Wn
Wn
Wn
lM
eY
"}
(23,1,1) = {"
zm
zm
zm
zm
zm
zm
zm
zm
Uf
Uf
Op
Uf
Uf
Uf
Uf
Uf
Uf
Uf
Uf
Uf
Uf
Uf
Uf
Uf
Uf
Uf
Uf
Uf
Uf
Uf
Uf
Uf
Uf
Uf
zm
Wn
Wn
Wn
lM
eY
"}
(24,1,1) = {"
gE
zm
Uf
Uf
Uf
Uf
Uf
zm
Uf
Uf
Op
Uf
Uf
Uf
Uf
Uf
Uf
Uf
Uf
Uf
Uf
Uf
Uf
Uf
Uf
Uf
Uf
Uf
Uf
Uf
Uf
Uf
Uf
Uf
zm
Wn
Wn
Wn
lM
eY
"}
(25,1,1) = {"
gE
gE
zm
Uf
Uf
Uf
Uf
zm
Uf
Uf
zm
zm
ER
zm
zm
zm
ve
zm
zm
zm
LG
zm
zm
zm
mX
zm
zm
zm
vS
zm
zm
zm
LI
zm
zm
Wn
Wn
Wn
lM
eY
"}
(26,1,1) = {"
gE
gE
gE
zm
Uf
Uf
Uf
jj
Uf
Uf
zm
Uf
Uf
Uf
zm
Uf
Uf
Uf
zm
Uf
Uf
Uf
zm
Uf
Uf
Uf
zm
Uf
Uf
Uf
zm
Uf
Uf
Uf
zm
Wn
Wn
Wn
lM
eY
"}
(27,1,1) = {"
gE
gE
gE
gE
zm
Uf
Uf
zm
Uf
Uf
zm
Uf
Uf
Uf
zm
Uf
Uf
Uf
zm
Uf
Uf
Uf
zm
Uf
Uf
Uf
zm
Uf
Uf
Uf
zm
Uf
Uf
Uf
zm
Wn
Wn
Wn
lM
eY
"}
(28,1,1) = {"
gE
gE
gE
gE
gE
zm
Uf
zm
Uf
Uf
zm
Uf
Uf
Uf
zm
Uf
Uf
Uf
zm
Uf
Uf
Uf
zm
Uf
Uf
Uf
zm
Uf
Uf
Uf
zm
Uf
Uf
Uf
zm
zm
zm
zm
Nt
Nt
"}
(29,1,1) = {"
gE
gE
gE
gE
gE
gE
zm
zm
Uf
Uf
zm
Uf
Uf
Uf
zm
Uf
Uf
Uf
zm
Uf
Uf
Uf
zm
Uf
Uf
Uf
zm
Uf
Uf
Uf
zm
Uf
Uf
Uf
zm
gE
gE
gE
gE
gE
"}
(30,1,1) = {"
gE
gE
gE
gE
gE
gE
gE
zm
EQ
EQ
zm
zm
EQ
zm
zm
zm
EQ
zm
zm
zm
EQ
zm
zm
zm
EQ
zm
zm
zm
EQ
zm
zm
zm
EQ
zm
zm
gE
gE
gE
gE
gE
"}
