//MAP CONVERTED BY dmm2tgm.py THIS HEADER COMMENT PREVENTS RECONVERSION, DO NOT REMOVE
"aE" = (
/obj/structure/table/reinforced,
/obj/effect/turf_decal/siding/wood{
	dir = 8
	},
/turf/open/floor/wood/parquet,
/area/shuttle/escape)
"aT" = (
/obj/structure/railing/corner{
	dir = 4
	},
/obj/machinery/door/airlock/shuttle{
	name = "Upper Floors"
	},
/obj/structure/barricade/wooden/crude,
/obj/effect/mapping_helpers/airlock/cutaiwire,
/obj/effect/mapping_helpers/airlock/locked,
/turf/open/floor/iron/dark,
/area/shuttle/escape)
"aY" = (
/obj/effect/turf_decal/siding/wood{
	dir = 1
	},
/turf/open/floor/wood/parquet,
/area/shuttle/escape)
"aZ" = (
/turf/open/floor/carpet/red,
/area/shuttle/escape)
"bn" = (
/obj/structure/chair/wood{
	dir = 4
	},
/turf/open/floor/carpet/red,
/area/shuttle/escape)
"bH" = (
/obj/structure/table/wood/fancy/black,
/obj/item/flashlight/flare/candle{
	pixel_y = 6
	},
/turf/open/floor/carpet/red,
/area/shuttle/escape)
"cf" = (
/obj/structure/window/reinforced/spawner/directional/north,
/obj/effect/turf_decal/delivery/white,
/obj/structure/closet/emcloset/anchored,
/turf/open/floor/iron/dark,
/area/shuttle/escape)
"cu" = (
/turf/open/floor/iron/dark,
/area/shuttle/escape)
"dp" = (
/obj/effect/turf_decal/tile/blue/anticorner/contrasted{
	dir = 8
	},
/obj/effect/turf_decal/trimline/blue/filled/corner{
	dir = 4
	},
/turf/open/floor/iron/white,
/area/shuttle/escape)
"dE" = (
/obj/effect/turf_decal/trimline/dark_red/line{
	dir = 6
	},
/obj/effect/turf_decal/trimline/dark_red/mid_joiner,
/obj/effect/turf_decal/trimline/dark_red/mid_joiner{
	dir = 4
	},
/turf/open/floor/iron/dark/smooth_corner{
	dir = 1
	},
/area/shuttle/escape/brig)
"dG" = (
/obj/machinery/door/airlock/medical/glass{
	name = "Infirmary"
	},
/obj/effect/mapping_helpers/airlock/access/any/medical/general,
/obj/effect/turf_decal/trimline/blue/filled/warning{
	dir = 4
	},
/obj/effect/turf_decal/trimline/blue/filled/warning{
	dir = 8
	},
/obj/effect/mapping_helpers/airlock/unres{
	dir = 4
	},
/turf/open/floor/iron/white/textured,
/area/shuttle/escape)
"dI" = (
/obj/effect/turf_decal/tile/blue/anticorner/contrasted{
	dir = 4
	},
/obj/effect/turf_decal/trimline/blue/filled/corner{
	dir = 8
	},
/obj/structure/table/optable,
/turf/open/floor/iron/white,
/area/shuttle/escape)
"dR" = (
/obj/machinery/power/shuttle_engine/heater{
	icon_state = "router"
	},
/turf/open/floor/plating/airless,
/area/shuttle/escape)
"dV" = (
/obj/structure/table/wood/fancy/black,
/obj/item/flashlight/flare/candle{
	pixel_y = 7;
	pixel_x = -6
	},
/turf/open/floor/carpet/red,
/area/shuttle/escape)
"ea" = (
/obj/effect/turf_decal/tile/blue/half/contrasted{
	dir = 1
	},
/obj/effect/turf_decal/trimline/blue/filled/line,
/turf/open/floor/iron/white,
/area/shuttle/escape)
"eb" = (
/obj/machinery/computer/warrant,
/obj/effect/turf_decal/trimline/dark_red/filled/line{
	dir = 9
	},
/turf/open/floor/iron,
/area/shuttle/escape)
"en" = (
/obj/effect/spawner/structure/window/reinforced/shuttle,
/turf/open/floor/plating,
/area/shuttle/escape)
"eG" = (
/obj/structure/railing{
	dir = 4
	},
/turf/open/floor/iron/stairs/medium,
/area/shuttle/escape)
"eQ" = (
/obj/machinery/door/airlock/security{
	name = "Holding Cells"
	},
/obj/effect/mapping_helpers/airlock/access/any/security/general,
/turf/open/floor/iron/dark/textured_large,
/area/shuttle/escape/brig)
"fI" = (
/obj/machinery/power/shuttle_engine/heater,
/obj/structure/window/reinforced/spawner/directional/north,
/turf/open/floor/plating/airless,
/area/shuttle/escape)
"ga" = (
/obj/machinery/door/airlock/command{
	name = "Corporate Lounge"
	},
/obj/effect/mapping_helpers/airlock/access/any/command,
/turf/open/floor/iron/dark,
/area/shuttle/escape)
"gb" = (
/obj/effect/turf_decal/trimline/dark_red/filled/line{
	dir = 10
	},
/obj/effect/turf_decal/trimline/dark_red/filled/mid_joiner,
/obj/effect/turf_decal/trimline/dark_red/filled/mid_joiner{
	dir = 8
	},
/turf/open/floor/iron/dark/smooth_corner{
	dir = 4
	},
/area/shuttle/escape/brig)
"ge" = (
/obj/structure/chair/wood,
/turf/open/floor/carpet/red,
/area/shuttle/escape)
"gm" = (
/obj/effect/turf_decal/trimline/dark_red/line{
	dir = 10
	},
/obj/effect/turf_decal/trimline/dark_red/mid_joiner,
/obj/effect/turf_decal/trimline/dark_red/mid_joiner{
	dir = 8
	},
/obj/structure/window/reinforced/spawner/directional/east,
/obj/structure/window/reinforced/spawner/directional/south,
/turf/open/floor/iron/dark/smooth_corner{
	dir = 4
	},
/area/shuttle/escape/brig)
"gE" = (
/obj/structure/window/reinforced/spawner/directional/east,
/turf/open/floor/iron/dark,
/area/shuttle/escape)
"ha" = (
/obj/machinery/door/airlock/glass_large{
	name = "Dorms"
	},
/obj/effect/mapping_helpers/airlock/locked,
/obj/effect/mapping_helpers/airlock/cutaiwire,
/obj/structure/barricade/wooden,
/turf/open/floor/iron,
/area/shuttle/escape)
"hD" = (
/turf/open/floor/carpet/executive,
/area/shuttle/escape)
"ib" = (
/obj/effect/turf_decal/trimline/dark_red/filled/line{
	dir = 9
	},
/obj/effect/turf_decal/trimline/dark_red/filled/mid_joiner{
	dir = 8
	},
/obj/effect/turf_decal/trimline/dark_red/filled/mid_joiner{
	dir = 1
	},
/turf/open/floor/iron/dark/smooth_corner,
/area/shuttle/escape/brig)
"ic" = (
/obj/structure/window/reinforced/spawner/directional/west,
/obj/structure/chair/sofa/bench/left{
	dir = 4
	},
/turf/open/floor/iron/dark,
/area/shuttle/escape)
"iP" = (
/obj/machinery/chem_master/condimaster{
	desc = "Looks like a knock-off chem-master. Perhaps useful for separating liquids when mixing drinks precisely. Also dispenses condiments.";
	name = "HoochMaster Deluxe"
	},
/obj/effect/turf_decal/siding/wood{
	dir = 1
	},
/turf/open/floor/wood/parquet,
/area/shuttle/escape)
"jt" = (
/turf/closed/wall/mineral/titanium,
/area/shuttle/escape)
"jT" = (
/obj/structure/window/reinforced/spawner/directional/south,
/obj/effect/turf_decal/delivery/white,
/obj/structure/closet/emcloset/anchored,
/turf/open/floor/iron/dark,
/area/shuttle/escape)
"kd" = (
/turf/template_noop,
/area/template_noop)
"kE" = (
/obj/effect/turf_decal/siding/wood{
	dir = 8
	},
/turf/open/floor/wood/parquet,
/area/shuttle/escape)
"kQ" = (
/obj/effect/turf_decal/trimline/dark_blue/filled/corner{
	dir = 4
	},
/turf/open/floor/iron,
/area/shuttle/escape)
"li" = (
/obj/structure/window/reinforced/spawner/directional/west,
/obj/structure/chair/sofa/bench/right{
	dir = 4
	},
/turf/open/floor/iron/dark,
/area/shuttle/escape)
"lC" = (
/obj/structure/table/reinforced,
/obj/effect/turf_decal/siding/wood{
	dir = 6
	},
/turf/open/floor/wood/parquet,
/area/shuttle/escape)
"lJ" = (
/obj/machinery/smartfridge/drinks,
/obj/effect/turf_decal/siding/wood{
	dir = 1
	},
/turf/open/floor/wood/parquet,
/area/shuttle/escape)
"lO" = (
/obj/structure/railing/corner{
	dir = 1
	},
/obj/machinery/door/airlock/shuttle{
	name = "Upper Floors"
	},
/obj/structure/barricade/wooden/crude,
/obj/effect/mapping_helpers/airlock/cutaiwire,
/obj/effect/mapping_helpers/airlock/locked,
/turf/open/floor/iron/dark,
/area/shuttle/escape)
"mj" = (
/obj/effect/turf_decal/trimline/dark_red/filled/line{
	dir = 8
	},
/obj/effect/turf_decal/trimline/dark_red/filled/mid_joiner{
	dir = 8
	},
/turf/open/floor/iron/dark/smooth_edge{
	dir = 8
	},
/area/shuttle/escape/brig)
"mo" = (
/obj/structure/railing{
	dir = 8
	},
/obj/structure/holosign/barrier/engineering,
/turf/open/floor/iron/stairs/left{
	dir = 1
	},
/area/shuttle/escape)
"my" = (
/obj/structure/railing{
	dir = 1
	},
/turf/open/floor/iron/stairs{
	dir = 8
	},
/area/shuttle/escape)
"nk" = (
/obj/effect/turf_decal/tile/blue/half/contrasted{
	dir = 1
	},
/obj/effect/turf_decal/trimline/blue/filled/line,
/obj/structure/window/reinforced/spawner/directional/west,
/obj/machinery/computer/operating,
/turf/open/floor/iron/white,
/area/shuttle/escape)
"nD" = (
/obj/structure/chair/wood{
	dir = 1
	},
/turf/open/floor/carpet/red,
/area/shuttle/escape)
"nI" = (
/obj/effect/turf_decal/tile/blue/half/contrasted{
	dir = 8
	},
/obj/effect/turf_decal/trimline/blue/filled/line{
	dir = 4
	},
/turf/open/floor/iron/white,
/area/shuttle/escape)
"nU" = (
/obj/structure/railing{
	dir = 2
	},
/turf/open/floor/iron/stairs{
	dir = 8
	},
/area/shuttle/escape)
"of" = (
/obj/structure/table/reinforced,
/obj/machinery/door/poddoor/shutters/preopen{
	name = "Captain's Quarters Privacy Shutters";
	dir = 8;
	id = cqpriv
	},
/obj/machinery/door/window/brigdoor/left/directional/west{
	name = "Captain's Desk";
	req_access = list("captain")
	},
/turf/open/floor/iron/dark/smooth_large,
/area/shuttle/escape)
"oo" = (
/obj/effect/turf_decal/siding/wood,
/turf/open/floor/wood/parquet,
/area/shuttle/escape)
"oH" = (
/obj/structure/table/reinforced,
/obj/effect/turf_decal/siding/wood{
	dir = 10
	},
/turf/open/floor/wood/parquet,
/area/shuttle/escape)
"pi" = (
/obj/structure/railing{
	dir = 4
	},
/turf/open/floor/iron/stairs/right{
	dir = 1
	},
/area/shuttle/escape)
"pF" = (
/obj/effect/turf_decal/trimline/blue/corner,
/turf/open/floor/iron,
/area/shuttle/escape)
"pK" = (
/obj/structure/railing/corner{
	dir = 8
	},
/turf/open/floor/carpet/red,
/area/shuttle/escape)
"qd" = (
/obj/effect/turf_decal/loading_area/white{
	dir = 4
	},
/turf/open/floor/iron/dark,
/area/shuttle/escape)
"qi" = (
/obj/structure/barricade/wooden,
/turf/open/floor/iron,
/area/shuttle/escape)
"qn" = (
/obj/structure/railing{
	dir = 1
	},
/obj/structure/holosign/barrier/engineering,
/turf/open/floor/iron/stairs{
	dir = 8
	},
/area/shuttle/escape)
"qr" = (
/turf/open/floor/iron/stairs/left,
/area/shuttle/escape)
"qt" = (
/obj/structure/railing{
	dir = 8
	},
/turf/open/floor/iron/stairs/medium,
/area/shuttle/escape)
"qw" = (
/obj/effect/turf_decal/trimline/dark_red/filled/corner{
	dir = 1
	},
/turf/open/floor/iron,
/area/shuttle/escape)
"qE" = (
/obj/machinery/door/airlock/shuttle,
/obj/effect/mapping_helpers/airlock/cyclelink_helper_multi{
	cycle_id = cruisene2
	},
/turf/open/floor/noslip,
/area/shuttle/escape)
"qM" = (
/obj/effect/turf_decal/tile/blue/anticorner/contrasted,
/obj/effect/turf_decal/trimline/blue/filled/corner{
	dir = 1
	},
/turf/open/floor/iron/white,
/area/shuttle/escape)
"re" = (
/obj/effect/turf_decal/trimline/dark_red/line{
	dir = 5
	},
/obj/effect/turf_decal/trimline/dark_red/mid_joiner{
	dir = 1
	},
/turf/open/floor/iron/dark/smooth_corner{
	dir = 8
	},
/area/shuttle/escape/brig)
"rw" = (
/obj/effect/turf_decal/siding/wood{
	dir = 6
	},
/turf/open/floor/wood/parquet,
/area/shuttle/escape)
"rI" = (
/obj/structure/table/reinforced,
/obj/effect/turf_decal/siding/wood{
	dir = 9
	},
/turf/open/floor/wood/parquet,
/area/shuttle/escape)
"sF" = (
/obj/effect/turf_decal/trimline/dark_red/filled/line{
	dir = 1
	},
/obj/effect/turf_decal/trimline/dark_red/filled/mid_joiner{
	dir = 1
	},
/obj/structure/window/reinforced/spawner/directional/east,
/turf/open/floor/iron/dark/smooth_edge{
	dir = 1
	},
/area/shuttle/escape/brig)
"sV" = (
/obj/effect/turf_decal/trimline/blue/arrow_cw{
	dir = 6
	},
/obj/effect/turf_decal/trimline/blue/corner{
	dir = 1
	},
/obj/effect/turf_decal/siding/thinplating{
	dir = 6
	},
/obj/structure/railing{
	dir = 2
	},
/turf/open/floor/iron,
/area/shuttle/escape)
"sW" = (
/obj/machinery/power/shuttle_engine/huge,
/turf/open/floor/plating/airless,
/area/shuttle/escape)
"tB" = (
/obj/structure/table/reinforced,
/obj/effect/turf_decal/trimline/dark_red/filled/corner{
	dir = 1
	},
/turf/open/floor/iron,
/area/shuttle/escape)
"ud" = (
/obj/structure/chair/stool/bar/directional/west,
/turf/open/floor/carpet/red,
/area/shuttle/escape)
"uh" = (
/obj/structure/railing{
	dir = 1
	},
/obj/structure/holosign/barrier/engineering,
/turf/open/floor/iron/stairs{
	dir = 4
	},
/area/shuttle/escape)
"uv" = (
/obj/effect/turf_decal/tile/blue/anticorner/contrasted{
	dir = 1
	},
/obj/effect/turf_decal/trimline/blue/filled/corner,
/turf/open/floor/iron/white,
/area/shuttle/escape)
"uV" = (
/turf/closed/wall/mineral/titanium/nodiagonal,
/area/shuttle/escape)
"uX" = (
/obj/machinery/door/airlock/command{
	name = "Bridge"
	},
/obj/effect/mapping_helpers/airlock/access/any/command,
/turf/open/floor/iron/textured_half,
/area/shuttle/escape)
"vt" = (
/obj/effect/turf_decal/trimline/dark_red/filled/line{
	dir = 1
	},
/obj/effect/turf_decal/trimline/dark_red/filled/mid_joiner{
	dir = 1
	},
/turf/open/floor/iron/dark/smooth_edge{
	dir = 1
	},
/area/shuttle/escape/brig)
"wa" = (
/obj/structure/table/wood/fancy/black,
/obj/item/flashlight/flare/candle{
	pixel_y = 10
	},
/turf/open/floor/carpet/red,
/area/shuttle/escape)
"wc" = (
/obj/structure/chair/sofa/corp{
	dir = 1
	},
/turf/open/floor/carpet/executive,
/area/shuttle/escape)
"wf" = (
/obj/structure/window/reinforced/spawner/directional/south,
/obj/effect/turf_decal/delivery/white,
/obj/structure/closet/firecloset/full,
/turf/open/floor/iron/dark,
/area/shuttle/escape)
"wl" = (
/obj/structure/railing{
	dir = 4
	},
/turf/open/floor/iron/stairs/right,
/area/shuttle/escape)
"wr" = (
/obj/structure/railing{
	dir = 4
	},
/obj/structure/holosign/barrier/engineering,
/turf/open/floor/iron/stairs/right{
	dir = 1
	},
/area/shuttle/escape)
"ws" = (
/obj/structure/chair/sofa/corp/left{
	dir = 4
	},
/turf/open/floor/carpet/executive,
/area/shuttle/escape)
"wF" = (
/obj/effect/turf_decal/trimline/blue/line{
	dir = 10
	},
/obj/effect/turf_decal/trimline/blue/mid_joiner,
/obj/effect/turf_decal/trimline/blue/mid_joiner{
	dir = 8
	},
/obj/structure/window/reinforced/spawner/directional/west,
/turf/open/floor/iron/white/smooth_large,
/area/shuttle/escape)
"wZ" = (
/obj/structure/railing{
	dir = 8
	},
/turf/open/floor/iron/stairs/left{
	dir = 1
	},
/area/shuttle/escape)
"xf" = (
/obj/effect/turf_decal/trimline/dark_blue/filled/line{
	dir = 5
	},
/obj/machinery/computer/crew{
	dir = 8
	},
/turf/open/floor/iron,
/area/shuttle/escape)
"xj" = (
/turf/open/floor/plating/airless,
/area/shuttle/escape)
"xB" = (
/obj/effect/spawner/structure/window/reinforced,
/obj/structure/flora/bush/flowers_br/style_random,
/obj/structure/flora/bush/ferny/style_random,
/obj/structure/flora/bush/flowers_pp/style_random,
/obj/structure/flora/bush/flowers_yw/style_random,
/obj/structure/barricade/wooden,
/turf/open/floor/grass,
/area/shuttle/escape)
"xE" = (
/obj/effect/turf_decal/trimline/dark_red/line{
	dir = 9
	},
/obj/effect/turf_decal/trimline/dark_red/mid_joiner{
	dir = 1
	},
/obj/structure/window/reinforced/spawner/directional/east,
/turf/open/floor/iron/dark/smooth_corner,
/area/shuttle/escape/brig)
"yn" = (
/turf/open/floor/iron,
/area/shuttle/escape)
"yt" = (
/obj/effect/turf_decal/tile/blue/half/contrasted{
	dir = 4
	},
/obj/effect/turf_decal/trimline/blue/filled/line{
	dir = 8
	},
/obj/machinery/door/window/brigdoor/right/directional/south{
	name = "Treatment Room";
	req_access = list("medical")
	},
/turf/open/floor/iron/white,
/area/shuttle/escape)
"zm" = (
/obj/machinery/button/door/directional/west{
	id = cqpriv;
	name = "Privacy Shutters Control"
	},
/obj/effect/turf_decal/siding/wood/end{
	dir = 1
	},
/turf/open/floor/wood/parquet,
/area/shuttle/escape)
"zv" = (
/obj/structure/railing/corner{
	dir = 1
	},
/turf/open/floor/iron,
/area/shuttle/escape)
"zH" = (
/obj/structure/table/reinforced,
/obj/machinery/door/poddoor/shutters/preopen{
	name = "Captain's Quarters Privacy Shutters";
	dir = 8;
	id = cqpriv
	},
/obj/structure/window/reinforced/spawner/directional/west,
/obj/machinery/recharger,
/turf/open/floor/iron/dark/smooth_large,
/area/shuttle/escape)
"zL" = (
/obj/structure/railing/corner,
/turf/open/floor/carpet/red,
/area/shuttle/escape)
"Ap" = (
/obj/structure/window/reinforced/spawner/directional/east,
/obj/structure/chair/sofa/bench/right{
	dir = 8
	},
/turf/open/floor/iron/dark,
/area/shuttle/escape)
"AJ" = (
/obj/structure/chair/wood{
	dir = 8
	},
/turf/open/floor/carpet/red,
/area/shuttle/escape)
"Bc" = (
/obj/effect/turf_decal/trimline/dark_red/filled/line{
	dir = 5
	},
/obj/effect/turf_decal/trimline/dark_red/filled/mid_joiner{
	dir = 4
	},
/obj/effect/turf_decal/trimline/dark_red/filled/mid_joiner{
	dir = 1
	},
/turf/open/floor/iron/dark/smooth_corner{
	dir = 8
	},
/area/shuttle/escape/brig)
"Cj" = (
/obj/structure/table/reinforced,
/obj/effect/turf_decal/siding/wood,
/turf/open/floor/wood/parquet,
/area/shuttle/escape)
"Cn" = (
/obj/effect/turf_decal/siding/wood{
	dir = 4
	},
/turf/open/floor/wood/parquet,
/area/shuttle/escape)
"Cw" = (
/obj/structure/window/reinforced/spawner/directional/north,
/obj/effect/turf_decal/delivery/white,
/obj/structure/closet/firecloset/full,
/turf/open/floor/iron/dark,
/area/shuttle/escape)
"Cx" = (
/obj/effect/turf_decal/trimline/dark_red/filled/line{
	dir = 4
	},
/obj/effect/turf_decal/trimline/dark_red/filled/mid_joiner{
	dir = 4
	},
/turf/open/floor/iron/dark/smooth_edge{
	dir = 4
	},
/area/shuttle/escape/brig)
"CG" = (
/obj/effect/turf_decal/trimline/dark_red/filled/line{
	dir = 6
	},
/obj/effect/turf_decal/trimline/dark_red/filled/mid_joiner,
/obj/effect/turf_decal/trimline/dark_red/filled/mid_joiner{
	dir = 4
	},
/turf/open/floor/iron/dark/smooth_corner{
	dir = 1
	},
/area/shuttle/escape/brig)
"CR" = (
/obj/docking_port/mobile/emergency{
	name = "The NTSS Independence"
	},
/obj/machinery/door/airlock/shuttle,
/obj/effect/mapping_helpers/airlock/cyclelink_helper_multi{
	cycle_id = cruisene2
	},
/turf/open/floor/noslip,
/area/shuttle/escape)
"Dq" = (
/turf/open/floor/iron/stairs/right,
/area/shuttle/escape)
"DA" = (
/turf/open/floor/light/colour_cycle/dancefloor_b,
/area/shuttle/escape)
"DJ" = (
/obj/effect/turf_decal/siding/wood{
	dir = 5
	},
/turf/open/floor/wood/parquet,
/area/shuttle/escape)
"El" = (
/obj/structure/table/reinforced,
/obj/machinery/chem_dispenser/drinks/fullupgrade{
	pixel_y = 8
	},
/obj/effect/turf_decal/siding/wood{
	dir = 1
	},
/turf/open/floor/wood/parquet,
/area/shuttle/escape)
"EC" = (
/obj/machinery/door/airlock/shuttle,
/obj/effect/mapping_helpers/airlock/cyclelink_helper_multi{
	cycle_id = cruisese2
	},
/turf/open/floor/iron/dark,
/area/shuttle/escape)
"FA" = (
/obj/structure{
	density = 1;
	icon = 'icons/obj/machines/shuttle_manipulator.dmi';
	icon_state = "hologram_on";
	layer = 2.8;
	light_color = "#2cb2e8";
	light_range = 2;
	max_integrity = 7500;
	mouse_opacity = 0;
	name = "holographic projection";
	pixel_x = -32;
	pixel_y = 17
	},
/obj/structure{
	desc = "This is the shuttle we're on. It's amazing what Nanotrasen can do once they actually put more than ten seconds of effort into their projects.";
	icon = 'icons/obj/machines/shuttle_manipulator.dmi';
	icon_state = "hologram_whiteship";
	layer = 4;
	light_color = "#2cb2e8";
	light_range = 7;
	max_integrity = 75000;
	name = "Cruise Shuttle Hologram";
	pixel_x = -32;
	pixel_y = 27
	},
/turf/open/floor/carpet/executive,
/area/shuttle/escape)
"GL" = (
/obj/machinery/door/airlock/command{
	name = "Captain's Quarters"
	},
/obj/effect/mapping_helpers/airlock/access/any/command/captain,
/obj/effect/turf_decal/trimline/blue/arrow_cw{
	dir = 4
	},
/obj/effect/turf_decal/trimline/blue/arrow_ccw{
	dir = 8
	},
/obj/effect/turf_decal/siding/thinplating/corner,
/turf/open/floor/iron,
/area/shuttle/escape)
"GR" = (
/obj/structure/table/wood/fancy/black,
/obj/item/flashlight/flare/candle{
	pixel_y = 8;
	pixel_x = -1
	},
/turf/open/floor/carpet/red,
/area/shuttle/escape)
"GT" = (
/obj/structure/railing{
	dir = 1
	},
/turf/open/floor/iron/stairs{
	dir = 4
	},
/area/shuttle/escape)
"Hn" = (
/obj/effect/turf_decal/trimline/blue/line{
	dir = 6
	},
/obj/effect/turf_decal/trimline/blue/mid_joiner,
/obj/effect/turf_decal/trimline/blue/mid_joiner{
	dir = 4
	},
/turf/open/floor/iron/white/smooth_large,
/area/shuttle/escape)
"Ho" = (
/obj/effect/turf_decal/trimline/blue/line{
	dir = 5
	},
/obj/effect/turf_decal/trimline/blue/mid_joiner{
	dir = 1
	},
/turf/open/floor/iron/white/smooth_large,
/area/shuttle/escape)
"HA" = (
/obj/structure/table/reinforced,
/obj/machinery/door/poddoor/shutters/preopen{
	name = "Captain's Quarters Privacy Shutters";
	dir = 8;
	id = cqpriv
	},
/obj/structure/window/reinforced/spawner/directional/west,
/turf/open/floor/iron/dark/smooth_large,
/area/shuttle/escape)
"HC" = (
/obj/effect/turf_decal/trimline/dark_red/filled/line{
	dir = 8
	},
/obj/effect/turf_decal/trimline/dark_red/filled/mid_joiner{
	dir = 8
	},
/obj/machinery/door/window/brigdoor/left/directional/south{
	req_access = list("brig");
	name = "Holding Cell"
	},
/turf/open/floor/iron/dark/smooth_edge{
	dir = 8
	},
/area/shuttle/escape/brig)
"HV" = (
/obj/structure/chair/sofa/corp/corner{
	dir = 1
	},
/turf/open/floor/carpet/executive,
/area/shuttle/escape)
"Iu" = (
/obj/machinery/computer/records/security{
	dir = 4
	},
/obj/effect/turf_decal/trimline/dark_red/filled/line{
	dir = 9
	},
/turf/open/floor/iron,
/area/shuttle/escape)
"Jq" = (
/obj/structure/railing{
	dir = 2
	},
/turf/open/floor/carpet/red,
/area/shuttle/escape)
"JA" = (
/obj/structure/railing/corner{
	dir = 4
	},
/turf/open/floor/iron,
/area/shuttle/escape)
"JG" = (
/obj/machinery/door/airlock/shuttle{
	name = "Laundry Room"
	},
/turf/open/floor/iron/dark,
/area/shuttle/escape)
"Kg" = (
/obj/structure/window/reinforced/spawner/directional/west,
/turf/open/floor/iron/dark,
/area/shuttle/escape)
"Ki" = (
/turf/open/floor/wood/parquet,
/area/shuttle/escape)
"KB" = (
/obj/machinery/door/airlock/shuttle,
/obj/effect/mapping_helpers/airlock/cyclelink_helper_multi{
	cycle_id = cruisenw2
	},
/turf/open/floor/noslip,
/area/shuttle/escape)
"LF" = (
/obj/machinery/vending/cigarette/beach,
/turf/open/floor/carpet/executive,
/area/shuttle/escape)
"Mb" = (
/obj/effect/turf_decal/trimline/dark_red/filled/line,
/obj/effect/turf_decal/trimline/dark_red/filled/mid_joiner,
/turf/open/floor/iron/dark/smooth_edge,
/area/shuttle/escape/brig)
"Md" = (
/obj/effect/turf_decal/tile/blue/half/contrasted,
/obj/effect/turf_decal/trimline/blue/filled/line{
	dir = 1
	},
/turf/open/floor/iron/white,
/area/shuttle/escape)
"Mf" = (
/obj/structure/chair/sofa/corp/right{
	dir = 1
	},
/turf/open/floor/carpet/executive,
/area/shuttle/escape)
"MI" = (
/obj/effect/turf_decal/siding/wood{
	dir = 10
	},
/turf/open/floor/wood/parquet,
/area/shuttle/escape)
"NA" = (
/obj/effect/turf_decal/delivery/white,
/turf/open/floor/iron/dark,
/area/shuttle/escape)
"NH" = (
/obj/machinery/door/airlock/shuttle,
/obj/effect/mapping_helpers/airlock/cyclelink_helper_multi{
	cycle_id = cruisese2
	},
/turf/open/floor/noslip,
/area/shuttle/escape)
"NJ" = (
/obj/effect/turf_decal/trimline/blue/line{
	dir = 9
	},
/obj/effect/turf_decal/trimline/blue/mid_joiner{
	dir = 1
	},
/obj/structure/window/reinforced/spawner/directional/west,
/obj/structure/window/reinforced/spawner/directional/south,
/obj/structure/table/reinforced,
/turf/open/floor/iron/white/smooth_large,
/area/shuttle/escape)
"Ob" = (
/obj/structure/railing{
	dir = 8
	},
/turf/open/floor/iron/stairs/left,
/area/shuttle/escape)
"Oh" = (
/obj/machinery/door/airlock/shuttle,
/obj/effect/mapping_helpers/airlock/cyclelink_helper_multi{
	cycle_id = cruisenw2
	},
/turf/open/floor/iron/dark,
/area/shuttle/escape)
"Oj" = (
/obj/effect/turf_decal/bot_white,
/turf/open/floor/iron/dark,
/area/shuttle/escape)
"Pa" = (
/obj/structure/chair/sofa/corp{
	dir = 4
	},
/turf/open/floor/carpet/executive,
/area/shuttle/escape)
"Pv" = (
/obj/structure/chair/stool/bar/directional/east,
/turf/open/floor/carpet/red,
/area/shuttle/escape)
"PK" = (
/obj/machinery/door/airlock/shuttle{
	name = "Cargo Hold"
	},
/obj/effect/mapping_helpers/airlock/access/any/supply/general,
/turf/open/floor/iron/dark,
/area/shuttle/escape)
"Qi" = (
/obj/structure/table/reinforced,
/obj/effect/turf_decal/siding/wood{
	dir = 5
	},
/turf/open/floor/wood/parquet,
/area/shuttle/escape)
"Ry" = (
/obj/structure/table/reinforced,
/turf/open/floor/carpet/executive,
/area/shuttle/escape)
"Sa" = (
/obj/machinery/washing_machine,
/turf/open/floor/iron/dark,
/area/shuttle/escape)
"Sp" = (
/obj/effect/turf_decal/siding/wood/corner{
	dir = 4
	},
/obj/effect/turf_decal/siding/wood{
	dir = 8
	},
/turf/open/floor/wood/parquet,
/area/shuttle/escape)
"TI" = (
/obj/machinery/vending/boozeomat/all_access,
/obj/effect/turf_decal/siding/wood{
	dir = 1
	},
/turf/open/floor/wood/parquet,
/area/shuttle/escape)
"Ul" = (
/obj/effect/turf_decal/tile/blue/half/contrasted{
	dir = 4
	},
/obj/effect/turf_decal/trimline/blue/filled/line{
	dir = 8
	},
/obj/machinery/vending/wallmed/directional/east{
	name = "\improper NanoMed"
	},
/turf/open/floor/iron/white,
/area/shuttle/escape)
"UJ" = (
/obj/structure/table/reinforced,
/obj/machinery/chem_dispenser/drinks/beer/fullupgrade{
	pixel_y = 8
	},
/obj/effect/turf_decal/siding/wood{
	dir = 1
	},
/turf/open/floor/wood/parquet,
/area/shuttle/escape)
"Vk" = (
/obj/machinery/computer/communications,
/obj/effect/turf_decal/trimline/dark_blue/filled/corner{
	dir = 4
	},
/turf/open/floor/iron,
/area/shuttle/escape)
"Vm" = (
/obj/machinery/computer/emergency_shuttle,
/obj/effect/turf_decal/trimline/dark_blue/filled/line{
	dir = 5
	},
/turf/open/floor/iron,
/area/shuttle/escape)
"Vx" = (
/obj/structure/table/reinforced,
/obj/effect/turf_decal/siding/wood{
	dir = 4
	},
/turf/open/floor/wood/parquet,
/area/shuttle/escape)
"Wu" = (
/obj/machinery/shuttle_manipulator{
	desc = "A holographic display of the cruise shuttle we're on right now.";
	layer = 2.7;
	max_integrity = 99999;
	name = "shuttle holographic display"
	},
/turf/open/floor/carpet/executive,
/area/shuttle/escape)
"WL" = (
/obj/structure/chair/stool/bar/directional/north,
/turf/open/floor/carpet/red,
/area/shuttle/escape)
"WT" = (
/obj/machinery/door/airlock/shuttle,
/obj/effect/mapping_helpers/airlock/cyclelink_helper_multi{
	cycle_id = cruisene2
	},
/turf/open/floor/iron/dark,
/area/shuttle/escape)
"XH" = (
/obj/structure/window/reinforced/spawner/directional/east,
/obj/structure/chair/sofa/bench/left{
	dir = 8
	},
/turf/open/floor/iron/dark,
/area/shuttle/escape)
"Yv" = (
/obj/effect/turf_decal/loading_area/white{
	dir = 8
	},
/turf/open/floor/iron/dark,
/area/shuttle/escape)
"YC" = (
/obj/effect/turf_decal/trimline/dark_blue/filled/corner{
	dir = 4
	},
/obj/effect/turf_decal/trimline/blue/corner,
/obj/effect/turf_decal/trimline/blue/corner{
	dir = 8
	},
/turf/open/floor/iron,
/area/shuttle/escape)
"ZK" = (
/turf/open/floor/light/colour_cycle/dancefloor_a,
/area/shuttle/escape)
"ZS" = (
/obj/machinery/jukebox,
/turf/open/floor/iron,
/area/shuttle/escape)

(1,1,1) = {"
kd
kd
kd
kd
kd
kd
kd
kd
kd
jt
qE
CR
jt
jt
KB
KB
jt
kd
kd
kd
kd
kd
kd
kd
kd
kd
kd
kd
kd
jt
qE
qE
jt
jt
qE
qE
jt
jt
jt
jt
kd
kd
kd
kd
"}
(2,1,1) = {"
kd
kd
kd
kd
kd
kd
kd
kd
kd
jt
qd
qd
jT
cf
qd
qd
jt
en
en
en
jt
kd
kd
kd
kd
jt
en
en
en
jt
qd
qd
jT
cf
qd
qd
jt
NA
cu
uV
jt
kd
kd
kd
"}
(3,1,1) = {"
kd
kd
kd
kd
kd
kd
kd
kd
kd
jt
cu
cu
wf
Cw
cu
cu
jt
yn
yn
yn
jt
jt
jt
jt
jt
jt
yn
yn
yn
jt
cu
cu
wf
Cw
cu
cu
jt
Oj
cu
uV
jt
jt
jt
kd
"}
(4,1,1) = {"
kd
kd
kd
kd
kd
kd
en
en
en
jt
WT
WT
jt
jt
Oh
Oh
jt
yn
yn
yn
jt
ib
mj
HC
gb
jt
yn
yn
yn
jt
WT
WT
jt
jt
WT
WT
jt
Oj
cu
uV
jt
jt
jt
jt
"}
(5,1,1) = {"
kd
kd
kd
kd
kd
en
en
ge
dV
nD
aZ
aZ
aZ
aZ
aZ
Jq
yn
yn
yn
yn
jt
sF
xE
gm
Mb
jt
yn
yn
yn
yn
yn
yn
yn
yn
yn
yn
jt
Oj
cu
fI
dR
xj
xj
sW
"}
(6,1,1) = {"
kd
kd
kd
kd
kd
en
bn
aZ
aZ
aZ
aZ
aZ
aZ
aZ
aZ
Jq
yn
yn
yn
yn
jt
vt
re
dE
Mb
jt
yn
yn
yn
yn
yn
yn
yn
yn
yn
yn
PK
cu
cu
fI
dR
xj
xj
xj
"}
(7,1,1) = {"
kd
kd
kd
kd
kd
en
wa
aZ
aZ
aZ
aZ
aZ
Pv
Pv
aZ
Jq
yn
yn
yn
yn
jt
Bc
Cx
Cx
CG
jt
yn
yn
yn
yn
yn
yn
yn
yn
yn
yn
jt
cu
cu
fI
dR
xj
xj
xj
"}
(8,1,1) = {"
kd
kd
kd
kd
kd
en
AJ
aZ
aZ
jt
rI
kE
aE
oH
WL
Jq
yn
yn
yn
yn
jt
eQ
jt
jt
jt
jt
yn
yn
yn
yn
yn
yn
yn
jt
jt
jt
jt
jt
aT
fI
xj
xj
sW
kd
"}
(9,1,1) = {"
kd
kd
kd
kd
kd
en
aZ
aZ
aZ
jt
lJ
Ki
Ki
Cj
WL
Jq
yn
yn
yn
yn
yn
yn
yn
yn
yn
yn
yn
yn
yn
yn
yn
yn
yn
jt
ws
Pa
HV
jt
qn
fI
xj
xj
xj
kd
"}
(10,1,1) = {"
kd
kd
kd
kd
kd
en
bn
aZ
bn
jt
UJ
Ki
Ki
Cj
WL
pK
Ob
zv
yn
yn
yn
yn
yn
yn
yn
yn
yn
jt
xB
xB
jt
yn
yn
ga
hD
hD
wc
jt
my
fI
xj
xj
xj
kd
"}
(11,1,1) = {"
kd
kd
kd
kd
kd
jt
bH
aZ
GR
jt
iP
Ki
Ki
Cj
WL
zL
eG
JA
yn
yn
jt
gE
Ap
XH
gE
jt
yn
ha
mo
wZ
jt
yn
yn
jt
Wu
hD
Mf
jt
uV
uV
uV
uV
uV
kd
"}
(12,1,1) = {"
kd
kd
kd
kd
kd
en
AJ
aZ
AJ
jt
El
Ki
Ki
Cj
WL
pK
qt
zv
yn
yn
jt
Kg
ic
li
Kg
jt
yn
qi
wr
pi
jt
yn
yn
jt
FA
hD
LF
jt
uV
uV
uV
uV
uV
kd
"}
(13,1,1) = {"
kd
kd
kd
kd
kd
en
aZ
aZ
aZ
jt
TI
Ki
Ki
Cj
WL
zL
wl
JA
yn
yn
yn
yn
yn
yn
yn
yn
yn
jt
xB
xB
jt
yn
yn
ga
hD
hD
hD
jt
GT
fI
xj
xj
sW
kd
"}
(14,1,1) = {"
kd
kd
kd
kd
kd
en
aZ
aZ
aZ
jt
Qi
Cn
Vx
lC
WL
Jq
DA
ZK
DA
yn
yn
yn
yn
yn
yn
yn
yn
yn
yn
yn
yn
yn
yn
jt
Ry
Ry
Ry
jt
uh
fI
xj
xj
xj
kd
"}
(15,1,1) = {"
kd
en
en
jt
jt
jt
aZ
aZ
aZ
aZ
aZ
aZ
ud
ud
aZ
Jq
ZK
DA
ZK
yn
jt
dG
jt
jt
jt
jt
yn
yn
yn
yn
yn
yn
yn
jt
jt
jt
jt
jt
lO
fI
xj
xj
xj
kd
"}
(16,1,1) = {"
en
en
Iu
qw
uX
qr
aZ
aZ
aZ
aZ
aZ
aZ
aZ
aZ
aZ
Jq
DA
ZK
DA
yn
jt
uv
nI
nI
dp
jt
yn
yn
yn
yn
yn
yn
yn
yn
yn
yn
jt
cu
cu
fI
dR
xj
xj
sW
"}
(17,1,1) = {"
en
eb
qw
yn
uX
Dq
aZ
aZ
aZ
aZ
aZ
aZ
aZ
aZ
aZ
Jq
ZK
DA
ZK
yn
jt
ea
Hn
Ho
Md
jt
yn
yn
yn
yn
yn
yn
yn
yn
yn
yn
JG
cu
cu
fI
dR
xj
xj
xj
"}
(18,1,1) = {"
en
tB
yn
yn
jt
jt
zH
of
HA
jt
aZ
aZ
aZ
aZ
aZ
Jq
ZS
yn
yn
yn
jt
nk
wF
NJ
Md
jt
yn
yn
yn
yn
yn
yn
yn
yn
yn
yn
jt
gE
cu
fI
dR
xj
xj
xj
"}
(19,1,1) = {"
en
Vk
yn
yn
jt
zm
Sp
kE
MI
jt
WT
WT
jt
jt
WT
WT
jt
yn
yn
yn
jt
dI
Ul
yt
qM
jt
yn
yn
yn
jt
EC
EC
jt
jt
EC
EC
jt
Sa
cu
uV
jt
jt
jt
jt
"}
(20,1,1) = {"
en
Vm
kQ
pF
jt
nU
aY
Ki
oo
jt
cu
cu
wf
Cw
cu
cu
jt
yn
yn
yn
jt
jt
jt
jt
jt
jt
yn
yn
yn
jt
cu
cu
wf
Cw
cu
cu
jt
Sa
cu
uV
jt
jt
jt
kd
"}
(21,1,1) = {"
en
en
xf
YC
GL
sV
DJ
Cn
rw
jt
Yv
Yv
jT
cf
Yv
Yv
jt
en
en
en
jt
kd
kd
kd
kd
jt
en
en
en
jt
Yv
Yv
jT
cf
Yv
Yv
jt
Sa
cu
uV
jt
kd
kd
kd
"}
(22,1,1) = {"
kd
en
en
jt
jt
jt
en
en
en
jt
qE
qE
jt
jt
qE
qE
jt
kd
kd
kd
kd
kd
kd
kd
kd
kd
kd
kd
kd
jt
NH
NH
jt
jt
NH
NH
jt
jt
jt
jt
kd
kd
kd
kd
"}
