"a" = (/turf/template_noop,/area/template_noop)
"d" = (/obj/machinery/door/airlock/security/glass{name = "Holding Area"},/turf/open/floor/iron/dark,/area/shuttle/escape/brig)
"e" = (/obj/effect/spawner/structure/window/reinforced/shuttle,/turf/open/floor/plating,/area/shuttle/escape)
"f" = (/turf/closed/wall/mineral/plastitanium,/area/shuttle/escape)
"g" = (/turf/closed/wall/mineral/titanium/nodiagonal,/area/shuttle/escape)
"k" = (/turf/open/floor/plating,/area/shuttle/escape)
"l" = (/turf/open/floor/iron/white,/area/shuttle/escape)
"m" = (/obj/effect/turf_decal/siding/blue{dir = 1},/turf/open/floor/iron/white,/area/shuttle/escape)
"n" = (/obj/effect/turf_decal/siding/blue{dir = 4},/turf/open/floor/iron/white,/area/shuttle/escape)
"p" = (/obj/effect/turf_decal/stripes/line{dir = 1},/obj/machinery/power/shuttle_engine/heater{dir = 1},/obj/structure/window/reinforced/spawner/directional/south,/turf/open/floor/plating/airless,/area/shuttle/escape)
"r" = (/obj/effect/turf_decal/siding/blue{dir = 10},/turf/open/floor/iron/white,/area/shuttle/escape)
"s" = (/obj/machinery/door/airlock/command/glass{name = "Cockpit"},/turf/open/floor/iron/white,/area/shuttle/escape)
"t" = (/obj/effect/turf_decal/siding/blue{dir = 9},/turf/open/floor/iron/white,/area/shuttle/escape)
"u" = (/obj/effect/turf_decal/siding/blue{dir = 5},/turf/open/floor/iron/white,/area/shuttle/escape)
"v" = (/obj/structure/window/reinforced/shuttle,/obj/structure/flora/bush/grassy/style_random,/obj/structure/flora/bush/flowers_br/style_random,/obj/structure/flora/bush/flowers_yw/style_random,/obj/structure/flora/bush/flowers_pp/style_random,/obj/structure/flora/bush/ferny/style_random,/turf/open/floor/grass,/area/shuttle/escape)
"x" = (/turf/open/floor/iron/dark,/area/shuttle/escape/brig)
"z" = (/obj/machinery/door/airlock/shuttle{name = "Emergency Shuttle Airlock"},/turf/open/floor/iron/white,/area/shuttle/escape)
"A" = (/obj/effect/turf_decal/siding/blue,/turf/open/floor/iron/white,/area/shuttle/escape)
"B" = (/obj/machinery/computer/emergency_shuttle{dir = 1},/turf/open/floor/iron/white,/area/shuttle/escape)
"C" = (/obj/machinery/door/airlock/medical/glass{name = "Medbay Storage"},/turf/open/floor/iron/white,/area/shuttle/escape)
"D" = (/turf/closed/wall/mineral/titanium,/area/shuttle/escape)
"H" = (/obj/machinery/door/airlock/shuttle{name = "Left Engine Maintenance"},/obj/effect/turf_decal/stripes/line{dir = 4},/obj/effect/turf_decal/stripes/line{dir = 8},/turf/open/floor/plating,/area/shuttle/escape)
"J" = (/obj/effect/turf_decal/siding/blue{dir = 8},/turf/open/floor/iron/white,/area/shuttle/escape)
"L" = (/obj/machinery/door/airlock/shuttle{name = "Right Engine Maintenance"},/obj/effect/turf_decal/stripes/line{dir = 4},/obj/effect/turf_decal/stripes/line{dir = 8},/turf/open/floor/plating,/area/shuttle/escape)
"M" = (/obj/effect/turf_decal/siding/blue{dir = 6},/turf/open/floor/iron/white,/area/shuttle/escape)
"N" = (/obj/machinery/door/airlock/medical/glass{name = "Treatment Center"},/turf/open/floor/iron/white,/area/shuttle/escape)
"P" = (/obj/machinery/door/airlock/public/glass{name = "Medical Corridor"},/turf/open/floor/iron/white,/area/shuttle/escape)
"R" = (/obj/effect/turf_decal/stripes/line{dir = 1},/turf/open/floor/plating,/area/shuttle/escape)
"S" = (/obj/structure/table/reinforced/rglass,/turf/open/floor/iron/white,/area/shuttle/escape)
"W" = (/obj/machinery/door/airlock/shuttle{name = "Emergency Shuttle Airlock"},/obj/docking_port/mobile/emergency{name = "Medical Evacuation Shuttle"},/turf/open/floor/iron/white,/area/shuttle/escape)
"X" = (/obj/effect/turf_decal/stripes/line{dir = 1},/obj/machinery/power/shuttle_engine/propulsion{dir = 1},/turf/open/floor/plating/airless,/area/shuttle/escape)
"Y" = (/obj/machinery/computer/communications{dir = 1},/turf/open/floor/iron/white,/area/shuttle/escape)

(1,1,1) = {"
aXXXXfDeeeeDfXXXXa
fppppfDllllDfppppf
DRRRRDDllllDDRRRRD
DkkkkDDDCCDDDkkkkD
DkkkkDllllllDkkkkD
DkkkkLllllllHkkkkD
DDDDDDDDllDDDDDDDD
DtmmmuDllllDllDlle
zJlglnPllllNlllllD
WJlvlnPllllNllDDDD
DJlglnDllllDllDlle
eJlSlnellllDlllllD
eJlSlnellllDllDDDD
DJlglnDllllDllDlle
zJlvlnPllllDlllllD
zJlglnPllllDllDDDD
DrAAAMDllllDllDlle
DDdDDDDllllDlllllD
DxxxxxDllllDllDDDD
exxxxxDllllDllDlle
DxxxxxDllllDlllllD
DxxxxxDllllNllDDDD
exxxxxDllllNllDlle
DxxxxxDllllDlllllD
DDDDDDDDssDDDDDDDD
aaaaelllllllleaaaa
aaaaelllllllleaaaa
aaaaelllllllleaaaa
aaaaDlllBYlllDaaaa
aaaaDDeeeeeeDDaaaa
"}
