//MAP CONVERTED BY dmm2tgm.py THIS HEADER COMMENT PREVENTS RECONVERSION, DO NOT REMOVE
"aY" = (
/obj/structure/railing{
	dir = 1
	},
/obj/effect/turf_decal/siding/wood{
	dir = 1
	},
/turf/open/floor/wood/parquet,
/area/shuttle/escape)
"cf" = (
/obj/structure/window/reinforced/spawner/directional/north,
/obj/effect/turf_decal/delivery/white,
/obj/structure/closet/emcloset/anchored,
/turf/open/floor/iron/dark,
/area/shuttle/escape)
"cu" = (
/turf/open/floor/iron/dark,
/area/shuttle/escape)
"dR" = (
/obj/machinery/power/shuttle_engine/heater{
	icon_state = "router"
	},
/turf/open/floor/plating/airless,
/area/shuttle/escape)
"eb" = (
/obj/machinery/computer/warrant,
/obj/effect/turf_decal/trimline/dark_red/filled/line{
	dir = 9
	},
/turf/open/floor/iron,
/area/shuttle/escape)
"en" = (
/obj/effect/spawner/structure/window/reinforced/shuttle,
/turf/open/floor/plating,
/area/shuttle/escape)
"fI" = (
/obj/machinery/power/shuttle_engine/heater,
/obj/structure/window/reinforced/spawner/directional/north,
/turf/open/floor/plating/airless,
/area/shuttle/escape)
"iP" = (
/obj/machinery/chem_master/condimaster{
	desc = "Looks like a knock-off chem-master. Perhaps useful for separating liquids when mixing drinks precisely. Also dispenses condiments.";
	name = "HoochMaster Deluxe"
	},
/turf/open/floor/wood/parquet,
/area/shuttle/escape)
"jt" = (
/turf/closed/wall/mineral/titanium,
/area/shuttle/escape)
"jT" = (
/obj/structure/window/reinforced/spawner/directional/south,
/obj/effect/turf_decal/delivery/white,
/obj/structure/closet/emcloset/anchored,
/turf/open/floor/iron/dark,
/area/shuttle/escape)
"kd" = (
/turf/template_noop,
/area/template_noop)
"kE" = (
/obj/effect/turf_decal/siding/wood{
	dir = 8
	},
/turf/open/floor/wood/parquet,
/area/shuttle/escape)
"kQ" = (
/obj/effect/turf_decal/trimline/dark_blue/filled/corner{
	dir = 4
	},
/turf/open/floor/iron,
/area/shuttle/escape)
"lJ" = (
/obj/machinery/smartfridge/drinks,
/turf/open/floor/wood/parquet,
/area/shuttle/escape)
"nU" = (
/turf/open/floor/iron/stairs{
	dir = 8
	},
/area/shuttle/escape)
"oo" = (
/obj/effect/turf_decal/siding/wood,
/turf/open/floor/wood/parquet,
/area/shuttle/escape)
"oH" = (
/obj/structure/table/reinforced,
/turf/open/floor/wood/parquet,
/area/shuttle/escape)
"qd" = (
/obj/effect/turf_decal/loading_area/white{
	dir = 4
	},
/turf/open/floor/iron/dark,
/area/shuttle/escape)
"qr" = (
/turf/open/floor/iron/stairs/left,
/area/shuttle/escape)
"qw" = (
/obj/effect/turf_decal/trimline/dark_red/filled/corner{
	dir = 1
	},
/turf/open/floor/iron,
/area/shuttle/escape)
"qE" = (
/obj/machinery/door/airlock/shuttle,
/obj/effect/mapping_helpers/airlock/cyclelink_helper_multi{
	cycle_id = cruisene2
	},
/turf/open/floor/noslip,
/area/shuttle/escape)
"rw" = (
/obj/effect/turf_decal/siding/wood{
	dir = 6
	},
/turf/open/floor/wood/parquet,
/area/shuttle/escape)
"sW" = (
/obj/machinery/power/shuttle_engine/huge,
/turf/open/floor/plating/airless,
/area/shuttle/escape)
"tB" = (
/obj/structure/table/reinforced,
/obj/effect/turf_decal/trimline/dark_red/filled/corner{
	dir = 1
	},
/turf/open/floor/iron,
/area/shuttle/escape)
"uV" = (
/turf/closed/wall/mineral/titanium/nodiagonal,
/area/shuttle/escape)
"uX" = (
/turf/open/floor/iron/textured_half,
/area/shuttle/escape)
"wf" = (
/obj/structure/window/reinforced/spawner/directional/south,
/obj/effect/turf_decal/delivery/white,
/obj/structure/closet/firecloset/full,
/turf/open/floor/iron/dark,
/area/shuttle/escape)
"xf" = (
/obj/effect/turf_decal/trimline/dark_blue/filled/line{
	dir = 5
	},
/obj/machinery/computer/crew{
	dir = 8
	},
/turf/open/floor/iron,
/area/shuttle/escape)
"xj" = (
/turf/open/floor/plating/airless,
/area/shuttle/escape)
"xB" = (
/turf/open/floor/plating,
/area/shuttle/escape)
"yn" = (
/turf/open/floor/iron,
/area/shuttle/escape)
"zm" = (
/obj/machinery/button/door/directional/west{
	id = cqpriv;
	name = "Privacy Shutters Control"
	},
/obj/effect/turf_decal/siding/wood/end{
	dir = 1
	},
/turf/open/floor/wood/parquet,
/area/shuttle/escape)
"Cn" = (
/obj/effect/turf_decal/siding/wood{
	dir = 4
	},
/turf/open/floor/wood/parquet,
/area/shuttle/escape)
"Cw" = (
/obj/structure/window/reinforced/spawner/directional/north,
/obj/effect/turf_decal/delivery/white,
/obj/structure/closet/firecloset/full,
/turf/open/floor/iron/dark,
/area/shuttle/escape)
"CR" = (
/obj/docking_port/mobile/emergency{
	name = "The NTSS Independence"
	},
/obj/machinery/door/airlock/shuttle,
/obj/effect/mapping_helpers/airlock/cyclelink_helper_multi{
	cycle_id = cruisene2
	},
/turf/open/floor/noslip,
/area/shuttle/escape)
"Dq" = (
/turf/open/floor/iron/stairs/right,
/area/shuttle/escape)
"DJ" = (
/obj/structure/railing{
	dir = 1
	},
/obj/effect/turf_decal/siding/wood{
	dir = 5
	},
/turf/open/floor/wood/parquet,
/area/shuttle/escape)
"El" = (
/obj/structure/table/reinforced,
/obj/machinery/chem_dispenser/drinks/fullupgrade{
	pixel_y = 8
	},
/turf/open/floor/wood/parquet,
/area/shuttle/escape)
"EC" = (
/obj/machinery/door/airlock/shuttle,
/obj/effect/mapping_helpers/airlock/cyclelink_helper_multi{
	cycle_id = cruisese2
	},
/turf/open/floor/iron/dark,
/area/shuttle/escape)
"HA" = (
/obj/structure/table/reinforced,
/obj/machinery/door/poddoor/shutters/preopen{
	name = "Captain's Quarters Privacy Shutters";
	dir = 8;
	id = cqpriv
	},
/turf/open/floor/wood/parquet,
/area/shuttle/escape)
"Iu" = (
/obj/machinery/computer/records/security{
	dir = 4
	},
/obj/effect/turf_decal/trimline/dark_red/filled/line{
	dir = 9
	},
/turf/open/floor/iron,
/area/shuttle/escape)
"Ki" = (
/turf/open/floor/wood/parquet,
/area/shuttle/escape)
"KB" = (
/obj/machinery/door/airlock/shuttle,
/obj/effect/mapping_helpers/airlock/cyclelink_helper_multi{
	cycle_id = cruisenw2
	},
/turf/open/floor/noslip,
/area/shuttle/escape)
"MI" = (
/obj/effect/turf_decal/siding/wood{
	dir = 10
	},
/turf/open/floor/wood/parquet,
/area/shuttle/escape)
"NH" = (
/obj/machinery/door/airlock/shuttle,
/obj/effect/mapping_helpers/airlock/cyclelink_helper_multi{
	cycle_id = cruisese2
	},
/turf/open/floor/noslip,
/area/shuttle/escape)
"Oh" = (
/obj/machinery/door/airlock/shuttle,
/obj/effect/mapping_helpers/airlock/cyclelink_helper_multi{
	cycle_id = cruisenw2
	},
/turf/open/floor/iron/dark,
/area/shuttle/escape)
"Sp" = (
/obj/effect/turf_decal/siding/wood/corner{
	dir = 4
	},
/obj/effect/turf_decal/siding/wood{
	dir = 8
	},
/turf/open/floor/wood/parquet,
/area/shuttle/escape)
"TI" = (
/obj/machinery/vending/boozeomat/all_access,
/turf/open/floor/wood/parquet,
/area/shuttle/escape)
"UJ" = (
/obj/structure/table/reinforced,
/obj/machinery/chem_dispenser/drinks/beer/fullupgrade{
	pixel_y = 8
	},
/turf/open/floor/wood/parquet,
/area/shuttle/escape)
"Vk" = (
/obj/machinery/computer/communications,
/obj/effect/turf_decal/trimline/dark_blue/filled/corner{
	dir = 4
	},
/turf/open/floor/iron,
/area/shuttle/escape)
"Vm" = (
/obj/machinery/computer/emergency_shuttle,
/obj/effect/turf_decal/trimline/dark_blue/filled/line{
	dir = 5
	},
/turf/open/floor/iron,
/area/shuttle/escape)
"WT" = (
/obj/machinery/door/airlock/shuttle,
/obj/effect/mapping_helpers/airlock/cyclelink_helper_multi{
	cycle_id = cruisene2
	},
/turf/open/floor/iron/dark,
/area/shuttle/escape)
"Yv" = (
/obj/effect/turf_decal/loading_area/white{
	dir = 8
	},
/turf/open/floor/iron/dark,
/area/shuttle/escape)

(1,1,1) = {"
kd
kd
kd
kd
kd
kd
kd
kd
kd
jt
qE
CR
jt
jt
KB
KB
jt
kd
kd
kd
kd
kd
kd
kd
kd
kd
kd
kd
kd
jt
qE
qE
jt
jt
qE
qE
jt
jt
jt
jt
kd
kd
kd
kd
"}
(2,1,1) = {"
kd
kd
kd
kd
kd
kd
kd
kd
kd
jt
qd
qd
jT
cf
qd
qd
jt
en
en
en
jt
kd
kd
kd
kd
jt
en
en
en
jt
qd
qd
jT
cf
qd
qd
jt
xB
xB
uV
jt
kd
kd
kd
"}
(3,1,1) = {"
kd
kd
kd
kd
kd
kd
kd
kd
kd
jt
cu
cu
wf
Cw
cu
cu
jt
xB
xB
xB
jt
jt
jt
jt
jt
jt
xB
xB
xB
jt
cu
cu
wf
Cw
cu
cu
jt
xB
xB
uV
jt
jt
jt
kd
"}
(4,1,1) = {"
kd
kd
kd
kd
kd
kd
en
en
en
jt
WT
WT
jt
jt
Oh
Oh
jt
xB
xB
xB
xB
xB
xB
xB
xB
xB
xB
xB
xB
jt
WT
WT
jt
jt
WT
WT
jt
xB
xB
uV
jt
jt
jt
jt
"}
(5,1,1) = {"
kd
kd
kd
kd
kd
en
en
xB
xB
xB
xB
xB
xB
xB
xB
xB
xB
xB
xB
xB
xB
xB
xB
xB
xB
xB
xB
xB
xB
xB
xB
xB
xB
xB
xB
xB
xB
xB
xB
fI
dR
xj
xj
sW
"}
(6,1,1) = {"
kd
kd
kd
kd
kd
en
xB
xB
xB
xB
xB
xB
xB
xB
xB
xB
xB
xB
xB
xB
xB
xB
xB
xB
xB
xB
xB
xB
xB
xB
xB
xB
xB
xB
xB
xB
xB
xB
xB
fI
dR
xj
xj
xj
"}
(7,1,1) = {"
kd
kd
kd
kd
kd
en
xB
xB
xB
xB
xB
xB
xB
xB
xB
xB
xB
xB
xB
xB
xB
xB
xB
xB
xB
xB
xB
xB
xB
xB
xB
xB
xB
xB
xB
xB
xB
xB
xB
fI
dR
xj
xj
xj
"}
(8,1,1) = {"
kd
kd
kd
kd
kd
en
xB
xB
xB
jt
oH
Ki
oH
oH
xB
xB
xB
xB
xB
xB
xB
xB
xB
xB
xB
xB
xB
xB
xB
xB
xB
xB
xB
xB
xB
xB
xB
xB
xB
fI
xj
xj
sW
kd
"}
(9,1,1) = {"
kd
kd
kd
kd
kd
en
xB
xB
xB
jt
lJ
Ki
Ki
oH
xB
xB
xB
xB
xB
xB
xB
xB
xB
xB
xB
xB
xB
xB
xB
xB
xB
xB
xB
xB
xB
xB
xB
xB
xB
fI
xj
xj
xj
kd
"}
(10,1,1) = {"
kd
kd
kd
kd
kd
en
xB
xB
xB
jt
UJ
Ki
Ki
oH
xB
xB
xB
xB
xB
xB
xB
xB
xB
xB
xB
xB
xB
xB
xB
xB
xB
xB
xB
xB
xB
xB
xB
xB
xB
fI
xj
xj
xj
kd
"}
(11,1,1) = {"
kd
kd
kd
kd
kd
jt
xB
xB
xB
jt
iP
Ki
Ki
oH
xB
xB
xB
xB
xB
xB
xB
xB
xB
xB
xB
xB
xB
xB
xB
xB
xB
xB
xB
xB
xB
xB
xB
xB
xB
uV
uV
uV
uV
kd
"}
(12,1,1) = {"
kd
kd
kd
kd
kd
en
xB
xB
xB
jt
El
Ki
Ki
oH
xB
xB
xB
xB
xB
xB
xB
xB
xB
xB
xB
xB
xB
xB
xB
xB
xB
xB
xB
xB
xB
xB
xB
xB
xB
uV
uV
uV
uV
kd
"}
(13,1,1) = {"
kd
kd
kd
kd
kd
en
xB
xB
xB
jt
TI
Ki
Ki
oH
xB
xB
xB
xB
xB
xB
xB
xB
xB
xB
xB
xB
xB
xB
xB
xB
xB
xB
xB
xB
xB
xB
xB
xB
xB
fI
xj
xj
sW
kd
"}
(14,1,1) = {"
kd
kd
kd
kd
kd
en
xB
xB
xB
jt
oH
Ki
oH
oH
xB
xB
xB
xB
xB
xB
xB
xB
xB
xB
xB
xB
xB
xB
xB
xB
xB
xB
xB
xB
xB
xB
xB
xB
xB
fI
xj
xj
xj
kd
"}
(15,1,1) = {"
kd
en
en
jt
jt
jt
xB
xB
xB
xB
xB
xB
xB
xB
xB
xB
xB
xB
xB
xB
xB
xB
xB
xB
xB
xB
xB
xB
xB
xB
xB
xB
xB
xB
xB
xB
xB
xB
xB
fI
xj
xj
xj
kd
"}
(16,1,1) = {"
en
en
Iu
qw
uX
qr
xB
xB
xB
xB
xB
xB
xB
xB
xB
xB
xB
xB
xB
xB
xB
xB
xB
xB
xB
xB
xB
xB
xB
xB
xB
xB
xB
xB
xB
xB
xB
xB
xB
fI
dR
xj
xj
sW
"}
(17,1,1) = {"
en
eb
qw
yn
uX
Dq
xB
xB
xB
xB
xB
xB
xB
xB
xB
xB
xB
xB
xB
xB
xB
xB
xB
xB
xB
xB
xB
xB
xB
xB
xB
xB
xB
xB
xB
xB
xB
xB
xB
fI
dR
xj
xj
xj
"}
(18,1,1) = {"
en
tB
yn
yn
jt
jt
HA
HA
HA
jt
xB
xB
xB
xB
xB
xB
xB
xB
xB
xB
xB
xB
xB
xB
xB
xB
xB
xB
xB
xB
xB
xB
xB
xB
xB
xB
xB
xB
xB
fI
dR
xj
xj
xj
"}
(19,1,1) = {"
en
Vk
yn
yn
jt
zm
Sp
kE
MI
jt
WT
WT
jt
jt
WT
WT
jt
xB
xB
xB
xB
xB
xB
xB
xB
xB
xB
xB
xB
jt
EC
EC
jt
jt
EC
EC
jt
xB
xB
uV
jt
jt
jt
jt
"}
(20,1,1) = {"
en
Vm
kQ
yn
jt
nU
aY
Ki
oo
jt
cu
cu
wf
Cw
cu
cu
jt
xB
xB
xB
jt
jt
jt
jt
jt
jt
xB
xB
xB
jt
cu
cu
wf
Cw
cu
cu
jt
xB
xB
uV
jt
jt
jt
kd
"}
(21,1,1) = {"
en
en
xf
kQ
yn
yn
DJ
Cn
rw
jt
Yv
Yv
jT
cf
Yv
Yv
jt
en
en
en
jt
kd
kd
kd
kd
jt
en
en
en
jt
Yv
Yv
jT
cf
Yv
Yv
jt
xB
xB
uV
jt
kd
kd
kd
"}
(22,1,1) = {"
kd
en
en
jt
jt
jt
en
en
en
jt
qE
qE
jt
jt
qE
qE
jt
kd
kd
kd
kd
kd
kd
kd
kd
kd
kd
kd
kd
jt
NH
NH
jt
jt
NH
NH
jt
jt
jt
jt
kd
kd
kd
kd
"}
