//MAP CONVERTED BY dmm2tgm.py THIS HEADER COMMENT PREVENTS RECONVERSION, DO NOT REMOVE
"a" = (
/turf/template_noop,
/area/template_noop)
"d" = (
/obj/machinery/door/airlock/security/glass{
	name = "Holding Area"
	},
/turf/open/floor/iron/dark,
/area/shuttle/escape/brig)
"e" = (
/obj/effect/spawner/structure/window/reinforced/shuttle,
/turf/open/floor/plating,
/area/shuttle/escape)
"f" = (
/turf/closed/wall/mineral/plastitanium,
/area/shuttle/escape)
"g" = (
/turf/closed/wall/mineral/titanium/nodiagonal,
/area/shuttle/escape)
"k" = (
/turf/open/floor/plating,
/area/shuttle/escape)
"l" = (
/turf/open/floor/iron/white,
/area/shuttle/escape)
"m" = (
/obj/effect/turf_decal/siding/blue{
	dir = 1
	},
/turf/open/floor/iron/white,
/area/shuttle/escape)
"n" = (
/obj/effect/turf_decal/siding/blue{
	dir = 4
	},
/turf/open/floor/iron/white,
/area/shuttle/escape)
"p" = (
/obj/effect/turf_decal/stripes/line{
	dir = 1
	},
/obj/machinery/power/shuttle_engine/heater{
	dir = 1
	},
/obj/structure/window/reinforced/spawner/directional/south,
/turf/open/floor/plating/airless,
/area/shuttle/escape)
"r" = (
/obj/effect/turf_decal/siding/blue{
	dir = 10
	},
/turf/open/floor/iron/white,
/area/shuttle/escape)
"s" = (
/obj/machinery/door/airlock/command/glass{
	name = "Cockpit"
	},
/turf/open/floor/iron/white,
/area/shuttle/escape)
"t" = (
/obj/effect/turf_decal/siding/blue{
	dir = 9
	},
/turf/open/floor/iron/white,
/area/shuttle/escape)
"u" = (
/obj/effect/turf_decal/siding/blue{
	dir = 5
	},
/turf/open/floor/iron/white,
/area/shuttle/escape)
"v" = (
/obj/structure/window/reinforced/shuttle,
/obj/structure/flora/bush/grassy/style_random,
/obj/structure/flora/bush/flowers_br/style_random,
/obj/structure/flora/bush/flowers_yw/style_random,
/obj/structure/flora/bush/flowers_pp/style_random,
/obj/structure/flora/bush/ferny/style_random,
/turf/open/floor/grass,
/area/shuttle/escape)
"x" = (
/turf/open/floor/iron/dark,
/area/shuttle/escape/brig)
"z" = (
/obj/machinery/door/airlock/shuttle{
	name = "Emergency Shuttle Airlock"
	},
/turf/open/floor/iron/white,
/area/shuttle/escape)
"A" = (
/obj/effect/turf_decal/siding/blue,
/turf/open/floor/iron/white,
/area/shuttle/escape)
"B" = (
/obj/machinery/computer/emergency_shuttle{
	dir = 1
	},
/turf/open/floor/iron/white,
/area/shuttle/escape)
"C" = (
/obj/machinery/door/airlock/medical/glass{
	name = "Medbay Storage"
	},
/turf/open/floor/iron/white,
/area/shuttle/escape)
"D" = (
/turf/closed/wall/mineral/titanium,
/area/shuttle/escape)
"H" = (
/obj/machinery/door/airlock/shuttle{
	name = "Left Engine Maintenance"
	},
/obj/effect/turf_decal/stripes/line{
	dir = 4
	},
/obj/effect/turf_decal/stripes/line{
	dir = 8
	},
/turf/open/floor/plating,
/area/shuttle/escape)
"J" = (
/obj/effect/turf_decal/siding/blue{
	dir = 8
	},
/turf/open/floor/iron/white,
/area/shuttle/escape)
"L" = (
/obj/machinery/door/airlock/shuttle{
	name = "Right Engine Maintenance"
	},
/obj/effect/turf_decal/stripes/line{
	dir = 4
	},
/obj/effect/turf_decal/stripes/line{
	dir = 8
	},
/turf/open/floor/plating,
/area/shuttle/escape)
"M" = (
/obj/effect/turf_decal/siding/blue{
	dir = 6
	},
/turf/open/floor/iron/white,
/area/shuttle/escape)
"N" = (
/obj/machinery/door/airlock/medical/glass{
	name = "Treatment Center"
	},
/turf/open/floor/iron/white,
/area/shuttle/escape)
"P" = (
/obj/machinery/door/airlock/public/glass{
	name = "Medical Corridor"
	},
/turf/open/floor/iron/white,
/area/shuttle/escape)
"R" = (
/obj/effect/turf_decal/stripes/line{
	dir = 1
	},
/turf/open/floor/plating,
/area/shuttle/escape)
"S" = (
/obj/structure/table/reinforced/rglass,
/turf/open/floor/iron/white,
/area/shuttle/escape)
"W" = (
/obj/machinery/door/airlock/shuttle{
	name = "Emergency Shuttle Airlock"
	},
/obj/docking_port/mobile/emergency{
	name = "Medical Evacuation Shuttle"
	},
/turf/open/floor/iron/white,
/area/shuttle/escape)
"X" = (
/obj/effect/turf_decal/stripes/line{
	dir = 1
	},
/obj/machinery/power/shuttle_engine/propulsion{
	dir = 1
	},
/turf/open/floor/plating/airless,
/area/shuttle/escape)
"Y" = (
/obj/machinery/computer/communications{
	dir = 1
	},
/turf/open/floor/iron/white,
/area/shuttle/escape)

(1,1,1) = {"
a
f
D
D
D
D
D
D
z
W
D
e
e
D
z
z
D
D
D
e
D
D
e
D
D
a
a
a
a
a
"}
(2,1,1) = {"
X
p
R
k
k
k
D
t
J
J
J
J
J
J
J
J
r
D
x
x
x
x
x
x
D
a
a
a
a
a
"}
(3,1,1) = {"
X
p
R
k
k
k
D
m
l
l
l
l
l
l
l
l
A
d
x
x
x
x
x
x
D
a
a
a
a
a
"}
(4,1,1) = {"
X
p
R
k
k
k
D
m
g
v
g
S
S
g
v
g
A
D
x
x
x
x
x
x
D
a
a
a
a
a
"}
(5,1,1) = {"
X
p
R
k
k
k
D
m
l
l
l
l
l
l
l
l
A
D
x
x
x
x
x
x
D
e
e
e
D
D
"}
(6,1,1) = {"
f
f
D
D
D
L
D
u
n
n
n
n
n
n
n
n
M
D
x
x
x
x
x
x
D
l
l
l
l
D
"}
(7,1,1) = {"
D
D
D
D
l
l
D
D
P
P
D
e
e
D
P
P
D
D
D
D
D
D
D
D
D
l
l
l
l
e
"}
(8,1,1) = {"
e
l
l
D
l
l
D
l
l
l
l
l
l
l
l
l
l
l
l
l
l
l
l
l
D
l
l
l
l
e
"}
(9,1,1) = {"
e
l
l
C
l
l
l
l
l
l
l
l
l
l
l
l
l
l
l
l
l
l
l
l
s
l
l
l
B
e
"}
(10,1,1) = {"
e
l
l
C
l
l
l
l
l
l
l
l
l
l
l
l
l
l
l
l
l
l
l
l
s
l
l
l
Y
e
"}
(11,1,1) = {"
e
l
l
D
l
l
D
l
l
l
l
l
l
l
l
l
l
l
l
l
l
l
l
l
D
l
l
l
l
e
"}
(12,1,1) = {"
D
D
D
D
l
l
D
D
N
N
D
D
D
D
D
D
D
D
D
D
D
N
N
D
D
l
l
l
l
e
"}
(13,1,1) = {"
f
f
D
D
D
H
D
l
l
l
l
l
l
l
l
l
l
l
l
l
l
l
l
l
D
l
l
l
l
D
"}
(14,1,1) = {"
X
p
R
k
k
k
D
l
l
l
l
l
l
l
l
l
l
l
l
l
l
l
l
l
D
e
e
e
D
D
"}
(15,1,1) = {"
X
p
R
k
k
k
D
D
l
D
D
l
D
D
l
D
D
l
D
D
l
D
D
l
D
a
a
a
a
a
"}
(16,1,1) = {"
X
p
R
k
k
k
D
l
l
D
l
l
D
l
l
D
l
l
D
l
l
D
l
l
D
a
a
a
a
a
"}
(17,1,1) = {"
X
p
R
k
k
k
D
l
l
D
l
l
D
l
l
D
l
l
D
l
l
D
l
l
D
a
a
a
a
a
"}
(18,1,1) = {"
a
f
D
D
D
D
D
e
D
D
e
D
D
e
D
D
e
D
D
e
D
D
e
D
D
a
a
a
a
a
"}
