//MAP CONVERTED BY dmm2tgm.py THIS HEADER COMMENT PREVENTS RECONVERSION, DO NOT REMOVE
"aa" = (
/turf/open/space/bluespace,
/area/misc/hilbertshotel)
"ab" = (
/turf/closed/indestructible/hotelwall,
/area/misc/hilbertshotel)
"ad" = (
/turf/open/indestructible/hotelwood,
/area/misc/hilbertshotel)
"ah" = (
/obj/structure/table/wood/fancy,
/turf/open/indestructible/hotelwood,
/area/misc/hilbertshotel)
"as" = (
/turf/closed/indestructible/hoteldoor,
/area/misc/hilbertshotel)
"aL" = (
/obj/effect/decal/cleanable/dirt,
/turf/open/indestructible/hotelwood,
/area/misc/hilbertshotel)
"aZ" = (
/obj/effect/decal/cleanable/dirt,
/turf/open/indestructible/hoteltile,
/area/misc/hilbertshotel)
"be" = (
/obj/machinery/light/small/directional/west,
/obj/effect/decal/cleanable/dirt,
/turf/open/indestructible/hotelwood,
/area/misc/hilbertshotel)
"bv" = (
/obj/machinery/shower/directional/west,
/turf/open/indestructible/hoteltile,
/area/misc/hilbertshotel)
"ck" = (
/obj/structure/window/reinforced/tinted/spawner/directional/west,
/obj/structure/window/reinforced/tinted/spawner/directional/north,
/turf/open/indestructible/hoteltile,
/area/misc/hilbertshotel)
"cm" = (
/turf/open/space/bluespace{
	density = 1;
	can_atmos_pass = 0
	},
/area/misc/hilbertshotel)
"cn" = (
/obj/machinery/shower/directional/west,
/obj/effect/decal/cleanable/dirt,
/turf/open/indestructible/hoteltile,
/area/misc/hilbertshotel)
"cZ" = (
/obj/structure/chair/comfy/brown{
	dir = 1
	},
/turf/open/indestructible/hotelwood,
/area/misc/hilbertshotel)
"dq" = (
/obj/effect/decal/cleanable/dirt,
/obj/machinery/light_switch/directional/east,
/turf/open/indestructible/hotelwood,
/area/misc/hilbertshotel)
"dF" = (
/obj/effect/decal/cleanable/cobweb,
/turf/open/indestructible/hotelwood,
/area/misc/hilbertshotel)
"dR" = (
/obj/machinery/light/small/directional/north,
/turf/open/indestructible/hoteltile,
/area/misc/hilbertshotel)
"ek" = (
/obj/structure/extinguisher_cabinet/directional/east,
/turf/open/indestructible/hotelwood,
/area/misc/hilbertshotel)
"eS" = (
/obj/structure/table/reinforced,
/obj/item/soap/homemade{
	name = "used soap"
	},
/turf/open/indestructible/hoteltile,
/area/misc/hilbertshotel)
"fO" = (
/obj/structure/chair/stool/bar/directional/south,
/turf/open/indestructible/hotelwood,
/area/misc/hilbertshotel)
"gb" = (
/obj/structure/closet/cabinet{
	anchored = 1
	},
/obj/item/mod/module/eradication_lock,
/turf/open/indestructible/hotelwood,
/area/misc/hilbertshotel)
"gV" = (
/obj/structure/table/wood/fancy,
/obj/structure/mirror/broken/directional/north,
/turf/open/indestructible/hotelwood,
/area/misc/hilbertshotel)
"id" = (
/obj/item/bikehorn/rubberducky,
/obj/machinery/light/small/directional/east,
/turf/open/indestructible/hoteltile,
/area/misc/hilbertshotel)
"iX" = (
/obj/structure/window/reinforced/tinted/spawner/directional/west,
/turf/open/indestructible/hoteltile,
/area/misc/hilbertshotel)
"jV" = (
/obj/structure/mineral_door/paperframe,
/turf/open/indestructible/hotelwood,
/area/misc/hilbertshotel)
"li" = (
/obj/structure/chair/comfy/brown{
	dir = 4
	},
/obj/machinery/light/small/directional/west,
/turf/open/indestructible/hotelwood,
/area/misc/hilbertshotel)
"lm" = (
/obj/structure/table/reinforced,
/obj/item/analyzer/hilbertsanalyzer,
/turf/open/indestructible/hotelwood,
/area/misc/hilbertshotel)
"mn" = (
/obj/structure/mineral_door/wood,
/turf/open/indestructible/hotelwood,
/area/misc/hilbertshotel)
"po" = (
/obj/structure/dresser,
/turf/open/indestructible/hotelwood,
/area/misc/hilbertshotel)
"rf" = (
/obj/structure/table/wood,
/obj/machinery/light/small/directional/north,
/obj/structure/showcase/machinery/tv/broken,
/turf/open/indestructible/hotelwood,
/area/misc/hilbertshotel)
"tS" = (
/obj/structure/table/wood,
/turf/open/indestructible/hotelwood,
/area/misc/hilbertshotel)
"ve" = (
/obj/machinery/door/window/left/directional/north,
/turf/open/indestructible/hotelwood,
/area/misc/hilbertshotel)
"xF" = (
/obj/structure/chair/comfy/brown{
	dir = 8
	},
/obj/machinery/light/small/directional/east,
/turf/open/indestructible/hotelwood,
/area/misc/hilbertshotel)
"yd" = (
/obj/machinery/light/small/directional/west,
/turf/open/indestructible/hotelwood,
/area/misc/hilbertshotel)
"yv" = (
/obj/machinery/light/small/directional/south,
/turf/open/indestructible/hotelwood,
/area/misc/hilbertshotel)
"zR" = (
/obj/structure/table/wood/fancy,
/obj/item/flashlight/lamp/green,
/turf/open/indestructible/hotelwood,
/area/misc/hilbertshotel)
"Aj" = (
/obj/effect/decal/cleanable/dirt,
/obj/effect/decal/cleanable/cobweb/cobweb2,
/turf/open/indestructible/hoteltile,
/area/misc/hilbertshotel)
"BD" = (
/obj/effect/decal/cleanable/vomit,
/turf/open/indestructible/hoteltile,
/area/misc/hilbertshotel)
"Ct" = (
/obj/structure/table/wood/poker,
/obj/effect/decal/cleanable/dirt,
/turf/open/indestructible/hotelwood,
/area/misc/hilbertshotel)
"Fd" = (
/obj/machinery/light/small/directional/south,
/turf/open/indestructible/hoteltile,
/area/misc/hilbertshotel)
"FK" = (
/obj/structure/table/reinforced,
/obj/item/pen,
/turf/open/indestructible/hotelwood,
/area/misc/hilbertshotel)
"HH" = (
/obj/structure/chair/stool/bar/directional/south,
/obj/effect/decal/cleanable/vomit,
/turf/open/indestructible/hotelwood,
/area/misc/hilbertshotel)
"HZ" = (
/obj/structure/table/wood/poker,
/turf/open/indestructible/hotelwood,
/area/misc/hilbertshotel)
"IR" = (
/obj/effect/decal/cleanable/dirt,
/obj/effect/decal/cleanable/dirt,
/turf/open/indestructible/hotelwood,
/area/misc/hilbertshotel)
"LL" = (
/obj/structure/bed,
/obj/effect/spawner/random/bedsheet/any,
/obj/effect/decal/cleanable/dirt,
/turf/open/indestructible/hotelwood,
/area/misc/hilbertshotel)
"LM" = (
/obj/structure/table/wood/poker,
/obj/item/toy/cards/deck,
/turf/open/indestructible/hotelwood,
/area/misc/hilbertshotel)
"Mi" = (
/obj/machinery/light_switch/directional/west,
/turf/open/indestructible/hotelwood,
/area/misc/hilbertshotel)
"Mn" = (
/obj/structure/table/wood/fancy,
/obj/machinery/light/small/directional/north,
/turf/open/indestructible/hotelwood,
/area/misc/hilbertshotel)
"Nj" = (
/obj/structure/table/reinforced,
/obj/machinery/light/small/directional/east,
/obj/effect/decal/cleanable/dirt,
/turf/open/indestructible/hotelwood,
/area/misc/hilbertshotel)
"NN" = (
/obj/structure/table/reinforced,
/obj/item/paper/crumpled/ruins/hotel_note,
/turf/open/indestructible/hotelwood,
/area/misc/hilbertshotel)
"Pl" = (
/obj/machinery/jukebox{
	req_access = null
	},
/turf/open/indestructible/hotelwood,
/area/misc/hilbertshotel)
"QL" = (
/obj/structure/closet/crate/bin,
/obj/machinery/light/small/directional/east,
/turf/open/indestructible/hotelwood,
/area/misc/hilbertshotel)
"RD" = (
/obj/structure/curtain,
/turf/open/indestructible/hoteltile,
/area/misc/hilbertshotel)
"Sf" = (
/obj/machinery/smartfridge/food,
/turf/open/indestructible/hotelwood,
/area/misc/hilbertshotel)
"Sh" = (
/turf/open/indestructible/hoteltile,
/area/misc/hilbertshotel)
"SS" = (
/obj/structure/table/reinforced,
/obj/machinery/microwave,
/turf/open/indestructible/hotelwood,
/area/misc/hilbertshotel)
"Tn" = (
/obj/structure/table/reinforced,
/turf/open/indestructible/hotelwood,
/area/misc/hilbertshotel)
"TW" = (
/obj/structure/table/reinforced,
/obj/machinery/light/small/directional/west,
/obj/item/soap/homemade{
	name = "used soap"
	},
/turf/open/indestructible/hoteltile,
/area/misc/hilbertshotel)
"VH" = (
/obj/structure/table/reinforced,
/obj/structure/sink/kitchen/directional/north,
/obj/machinery/light/small/directional/south,
/turf/open/indestructible/hotelwood,
/area/misc/hilbertshotel)
"Wu" = (
/obj/structure/mirror/directional/west,
/obj/structure/sink/directional/east,
/obj/effect/decal/cleanable/dirt,
/turf/open/indestructible/hoteltile,
/area/misc/hilbertshotel)
"YK" = (
/obj/structure/toilet{
	dir = 8
	},
/obj/structure/window/reinforced/tinted/spawner/directional/north,
/obj/structure/window/reinforced/tinted/spawner/directional/west,
/turf/open/indestructible/hoteltile,
/area/misc/hilbertshotel)
"YW" = (
/obj/structure/mirror/directional/west,
/obj/structure/sink/directional/east,
/turf/open/indestructible/hoteltile,
/area/misc/hilbertshotel)
"Zo" = (
/obj/structure/window/reinforced/tinted/spawner/directional/west,
/obj/structure/window/reinforced/tinted/spawner/directional/south,
/turf/open/indestructible/hoteltile,
/area/misc/hilbertshotel)

(1,1,1) = {"
aa
aa
aa
aa
aa
aa
aa
aa
aa
aa
aa
aa
aa
aa
aa
"}
(2,1,1) = {"
aa
ab
ab
cm
ab
ab
as
ab
ab
cm
ab
ab
ab
ab
aa
"}
(3,1,1) = {"
aa
ab
dF
aL
li
ad
aL
yd
cm
ve
be
SS
cm
ab
aa
"}
(4,1,1) = {"
aa
cm
tS
ad
HZ
cZ
ad
ad
fO
FK
ad
aL
Tn
cm
aa
"}
(5,1,1) = {"
aa
ab
rf
ad
LM
cZ
aL
ad
HH
NN
ad
aL
VH
ab
aa
"}
(6,1,1) = {"
aa
ab
tS
cm
Ct
cZ
ad
ad
fO
lm
IR
IR
cm
cm
aa
"}
(7,1,1) = {"
aa
cm
Pl
aL
xF
ad
dq
QL
ek
Tn
Nj
Sf
Tn
ab
aa
"}
(8,1,1) = {"
aa
ab
cm
ab
cm
mn
ab
ab
ab
ab
ab
ab
ab
ab
aa
"}
(9,1,1) = {"
aa
ab
po
ad
yd
ad
Mi
jV
Sh
Wu
TW
YW
eS
cm
aa
"}
(10,1,1) = {"
aa
ab
ah
ad
aL
aL
cm
ab
cm
aZ
Sh
aZ
cm
ab
aa
"}
(11,1,1) = {"
aa
ab
gV
ad
ad
aL
yv
cm
dR
Sh
YK
BD
Fd
ab
aa
"}
(12,1,1) = {"
aa
ab
Mn
cm
aL
ad
gb
ab
RD
ck
iX
Zo
RD
ab
aa
"}
(13,1,1) = {"
aa
cm
cm
ad
aL
cm
ad
ab
Sh
Sh
aZ
aZ
Sh
ab
aa
"}
(14,1,1) = {"
aa
ab
aL
zR
cm
LL
ah
ab
Aj
cn
id
bv
cm
ab
aa
"}
(15,1,1) = {"
aa
ab
cm
ab
cm
ab
ab
ab
ab
ab
ab
ab
cm
ab
aa
"}
(16,1,1) = {"
aa
aa
aa
aa
aa
aa
aa
aa
aa
aa
aa
aa
aa
aa
aa
"}
