//MAP CONVERTED BY dmm2tgm.py THIS HEADER COMMENT PREVENTS RECONVERSION, DO NOT REMOVE
"ac" = (
/obj/structure/chair{
	dir = 1
	},
/turf/open/floor/holofloor/chapel/bottom_left,
/area/template_noop)
"af" = (
/turf/open/floor/holofloor/dark,
/area/template_noop)
"ag" = (
/turf/open/floor/holofloor/chapel/top_left,
/area/template_noop)
"ai" = (
/turf/open/floor/holofloor/chapel/bottom_right,
/area/template_noop)
"ak" = (
/obj/structure/chair{
	dir = 1
	},
/turf/open/floor/holofloor/chapel/top_right,
/area/template_noop)
"an" = (
/obj/structure/table/wood,
/obj/effect/turf_decal/tile/neutral/half/contrasted,
/turf/open/floor/holofloor/dark,
/area/template_noop)
"az" = (
/obj/structure/closet/secure_closet/courtroom,
/obj/effect/turf_decal/tile/neutral/opposingcorners{
	dir = 1
	},
/turf/open/floor/holofloor/dark,
/area/template_noop)
"aA" = (
/turf/open/floor/holofloor/chapel/bottom_left,
/area/template_noop)
"aC" = (
/obj/structure/chair{
	dir = 1
	},
/turf/open/floor/holofloor/chapel,
/area/template_noop)
"aE" = (
/obj/structure/chair{
	dir = 1
	},
/turf/open/floor/holofloor/chapel/bottom_right,
/area/template_noop)
"aJ" = (
/obj/effect/turf_decal/tile/neutral/half/contrasted{
	dir = 8
	},
/turf/open/floor/holofloor/dark,
/area/template_noop)
"aK" = (
/turf/open/floor/holofloor/chapel/top_right,
/area/template_noop)
"aM" = (
/obj/effect/turf_decal/tile/neutral/opposingcorners{
	dir = 1
	},
/turf/open/floor/holofloor/dark,
/area/template_noop)
"aP" = (
/obj/effect/turf_decal/tile/neutral/fourcorners,
/turf/open/floor/holofloor/dark,
/area/template_noop)
"aQ" = (
/obj/structure/chair,
/turf/open/floor/holofloor/dark,
/area/template_noop)
"aR" = (
/obj/effect/turf_decal/tile/neutral/anticorner/contrasted,
/turf/open/floor/holofloor/dark,
/area/template_noop)
"aT" = (
/obj/structure/chair{
	dir = 1
	},
/turf/open/floor/holofloor/chapel/top_left,
/area/template_noop)
"aV" = (
/obj/structure/chair{
	dir = 1
	},
/obj/effect/turf_decal/tile/neutral/opposingcorners{
	dir = 1
	},
/turf/open/floor/holofloor/dark,
/area/template_noop)
"aZ" = (
/obj/effect/turf_decal/tile/neutral/anticorner/contrasted{
	dir = 8
	},
/turf/open/floor/holofloor/dark,
/area/template_noop)
"fi" = (
/obj/structure/table/wood,
/obj/item/storage/fancy/candle_box,
/obj/effect/turf_decal/tile/neutral/opposingcorners{
	dir = 1
	},
/turf/open/floor/holofloor/dark,
/area/template_noop)
"nt" = (
/obj/item/clothing/suit/chaplainsuit/bishoprobe,
/obj/structure/table/wood/fancy,
/obj/effect/turf_decal/tile/neutral/fourcorners,
/turf/open/floor/holofloor/dark,
/area/template_noop)
"sj" = (
/obj/structure/table/wood,
/obj/item/folder/red,
/obj/item/pen/red,
/obj/effect/turf_decal/tile/neutral/opposingcorners{
	dir = 1
	},
/turf/open/floor/holofloor/dark,
/area/template_noop)
"ta" = (
/obj/structure/table/wood,
/obj/item/hand_labeler,
/obj/effect/turf_decal/tile/neutral/opposingcorners{
	dir = 1
	},
/turf/open/floor/holofloor/dark,
/area/template_noop)
"wd" = (
/obj/item/clothing/suit/costume/judgerobe,
/obj/item/clothing/head/costume/powdered_wig,
/obj/structure/table/wood/fancy,
/obj/effect/turf_decal/tile/neutral/fourcorners,
/turf/open/floor/holofloor/dark,
/area/template_noop)
"xZ" = (
/obj/item/gavelblock,
/obj/item/gavelhammer,
/obj/structure/table/wood,
/obj/effect/turf_decal/tile/neutral/half/contrasted,
/turf/open/floor/holofloor/dark,
/area/template_noop)
"EC" = (
/obj/structure/table/wood/fancy,
/obj/item/book/manual/wiki/security_space_law,
/obj/effect/turf_decal/tile/neutral/fourcorners,
/turf/open/floor/holofloor/dark,
/area/template_noop)
"Fx" = (
/obj/structure/table/wood,
/obj/item/paper_bin,
/obj/effect/turf_decal/tile/neutral/opposingcorners{
	dir = 1
	},
/turf/open/floor/holofloor/dark,
/area/template_noop)
"Fz" = (
/obj/structure/table/wood,
/obj/item/food/grown/harebell,
/obj/item/food/grown/harebell,
/obj/item/food/grown/harebell,
/obj/item/food/grown/harebell,
/obj/item/food/grown/harebell,
/obj/effect/turf_decal/tile/neutral/opposingcorners{
	dir = 1
	},
/turf/open/floor/holofloor/dark,
/area/template_noop)
"FD" = (
/obj/structure/table/wood,
/obj/item/folder/blue,
/obj/item/pen/red,
/obj/effect/turf_decal/tile/neutral/opposingcorners{
	dir = 1
	},
/turf/open/floor/holofloor/dark,
/area/template_noop)
"FQ" = (
/obj/structure/table/wood/fancy,
/obj/item/book/bible,
/obj/effect/turf_decal/tile/neutral/fourcorners,
/turf/open/floor/holofloor/dark,
/area/template_noop)
"HA" = (
/obj/item/clothing/head/helmet/chaplain/witchunter_hat,
/obj/structure/table/wood/fancy,
/obj/effect/turf_decal/tile/neutral/fourcorners,
/turf/open/floor/holofloor/dark,
/area/template_noop)
"Jt" = (
/obj/structure/table/wood/fancy,
/obj/item/clothing/suit/chaplainsuit/nun,
/obj/item/clothing/head/chaplain/nun_hood,
/obj/item/clothing/suit/chaplainsuit/holidaypriest,
/obj/effect/turf_decal/tile/neutral/fourcorners,
/turf/open/floor/holofloor/dark,
/area/template_noop)
"Kk" = (
/obj/effect/turf_decal/tile/neutral/half/contrasted{
	dir = 4
	},
/turf/open/floor/holofloor/dark,
/area/template_noop)
"KK" = (
/obj/item/toy/figure/chaplain,
/obj/structure/table/wood/fancy,
/obj/effect/turf_decal/tile/neutral/fourcorners,
/turf/open/floor/holofloor/dark,
/area/template_noop)
"Sw" = (
/obj/structure/table/wood,
/obj/item/food/grown/poppy,
/obj/item/food/grown/poppy,
/obj/item/food/grown/poppy,
/obj/item/food/grown/poppy,
/obj/item/food/grown/poppy,
/obj/effect/turf_decal/tile/neutral/opposingcorners{
	dir = 1
	},
/turf/open/floor/holofloor/dark,
/area/template_noop)

(1,1,1) = {"
aP
ag
aA
ag
ac
aT
aA
aV
aV
az
"}
(2,1,1) = {"
KK
aK
ai
aK
aC
ak
ai
aV
aV
Fx
"}
(3,1,1) = {"
wd
aJ
aZ
ag
ac
aT
aA
aV
aV
sj
"}
(4,1,1) = {"
Jt
af
an
aK
aC
ak
ai
aV
aV
FD
"}
(5,1,1) = {"
FQ
aQ
xZ
aP
aP
aP
aP
aM
aM
Sw
"}
(6,1,1) = {"
EC
af
an
ag
ac
aT
aA
aV
aV
Fz
"}
(7,1,1) = {"
HA
Kk
aR
aK
aE
ak
ai
aV
aV
fi
"}
(8,1,1) = {"
nt
ag
aA
ag
ac
aT
aA
aV
aV
ta
"}
(9,1,1) = {"
aP
aK
ai
aK
aE
ak
ai
aV
aV
az
"}
