//MAP CONVERTED BY dmm2tgm.py THIS HEADER COMMENT PREVENTS RECONVERSION, DO NOT REMOVE
"a" = (
/obj/structure/chair/wood{
	dir = 1
	},
/turf/open/floor/holofloor/grass,
/area/template_noop)
"b" = (
/obj/machinery/door/window/right/directional/south,
/turf/open/floor/holofloor/grass,
/area/template_noop)
"e" = (
/obj/structure/table/wood,
/obj/item/scythe,
/obj/item/spear,
/obj/item/melee/chainofcommand{
	name = "chain whip"
	},
/turf/open/floor/holofloor/asteroid,
/area/template_noop)
"h" = (
/obj/machinery/door/window/left/directional/south,
/turf/open/floor/holofloor/asteroid,
/area/template_noop)
"m" = (
/obj/structure/table/wood,
/obj/item/melee/chainofcommand{
	name = "chain whip"
	},
/obj/item/spear,
/turf/open/floor/holofloor/asteroid,
/area/template_noop)
"o" = (
/obj/structure/window/reinforced/spawner/directional/south,
/obj/item/banner/red,
/turf/open/floor/holofloor/asteroid,
/area/template_noop)
"p" = (
/turf/open/floor/holofloor/asteroid,
/area/template_noop)
"q" = (
/obj/machinery/door/window/left/directional/south,
/turf/open/floor/holofloor/grass,
/area/template_noop)
"v" = (
/obj/structure/table/wood,
/obj/item/tailclub,
/obj/item/spear,
/turf/open/floor/holofloor/asteroid,
/area/template_noop)
"w" = (
/obj/structure/window/reinforced/spawner/directional/south,
/obj/item/banner/blue,
/turf/open/floor/holofloor/asteroid,
/area/template_noop)
"x" = (
/turf/open/floor/holofloor/grass,
/area/template_noop)
"B" = (
/turf/open/floor/holofloor{
	icon_state = "stairs-old"
	},
/area/template_noop)
"F" = (
/obj/structure/table/wood,
/obj/item/scythe,
/obj/item/spear,
/turf/open/floor/holofloor/asteroid,
/area/template_noop)
"G" = (
/obj/structure/table/wood/fancy,
/obj/item/clothing/head/costume/crown/fancy{
	pixel_y = 6
	},
/turf/open/floor/holofloor/grass,
/area/template_noop)
"H" = (
/obj/structure/statue/diamond/captain,
/turf/open/floor/holofloor/grass,
/area/template_noop)
"I" = (
/obj/structure/table/wood/fancy,
/obj/item/clothing/suit/armor/riot/knight/blue,
/obj/item/clothing/head/helmet/knight/blue,
/turf/open/floor/holofloor/grass,
/area/template_noop)
"K" = (
/obj/structure/table/wood/fancy,
/obj/item/clothing/suit/armor/riot/knight/blue,
/obj/item/clothing/head/helmet/knight/blue,
/obj/item/claymore/weak,
/turf/open/floor/holofloor/grass,
/area/template_noop)
"L" = (
/obj/structure/table/wood,
/obj/item/spear,
/turf/open/floor/holofloor/asteroid,
/area/template_noop)
"O" = (
/obj/structure/window/reinforced/spawner/directional/south,
/turf/open/floor/holofloor/grass,
/area/template_noop)
"P" = (
/obj/structure/window/reinforced/spawner/directional/south,
/turf/open/floor/holofloor/asteroid,
/area/template_noop)

(1,1,1) = {"
H
O
L
p
p
p
p
w
x
a
"}
(2,1,1) = {"
x
O
e
p
p
p
p
P
x
a
"}
(3,1,1) = {"
I
b
B
p
p
p
p
P
x
a
"}
(4,1,1) = {"
K
O
m
p
p
p
p
h
x
a
"}
(5,1,1) = {"
G
O
F
p
p
p
p
P
x
a
"}
(6,1,1) = {"
K
O
v
p
p
p
p
h
x
a
"}
(7,1,1) = {"
I
q
B
p
p
p
p
P
x
a
"}
(8,1,1) = {"
x
O
m
p
p
p
p
P
x
a
"}
(9,1,1) = {"
H
O
v
p
p
p
p
o
x
a
"}
