//MAP CONVERTED BY dmm2tgm.py THIS HEADER COMMENT PREVENTS RECONVERSION, DO NOT REMOVE
"aa" = (
/turf/closed/wall/mineral/titanium/survival/pod,
/area/misc/survivalpod)
"ab" = (
/obj/effect/turf_decal/mining/survival{
	dir = 4
	},
/obj/structure/disposalpipe/segment{
	dir = 9
	},
/turf/closed/wall/mineral/titanium/survival/nodiagonal,
/area/misc/survivalpod)
"ac" = (
/turf/closed/wall/mineral/titanium/survival/nodiagonal,
/area/misc/survivalpod)
"ad" = (
/obj/structure/sink/directional/west,
/obj/machinery/light/small/directional/east,
/obj/structure/urinal/directional/north,
/obj/structure/mirror/directional/east,
/turf/open/floor/pod/light,
/area/misc/survivalpod)
"ae" = (
/obj/structure/chair/stool/bar/directional/south,
/turf/open/floor/carpet/black,
/area/misc/survivalpod)
"af" = (
/obj/structure/table/wood/fancy/black,
/obj/machinery/chem_dispenser/drinks{
	pixel_y = 8
	},
/turf/open/floor/pod/dark,
/area/misc/survivalpod)
"ag" = (
/obj/structure/table/wood/fancy/black,
/obj/machinery/chem_dispenser/drinks/beer{
	pixel_y = 8
	},
/obj/machinery/light/directional/north,
/turf/open/floor/pod/dark,
/area/misc/survivalpod)
"ah" = (
/obj/machinery/vending/boozeomat/all_access{
	onstation = 0
	},
/turf/open/floor/pod/dark,
/area/misc/survivalpod)
"ai" = (
/obj/item/book/manual/wiki/barman_recipes{
	pixel_y = 8
	},
/obj/item/reagent_containers/cup/glass/shaker{
	pixel_y = 8
	},
/obj/item/reagent_containers/cup/rag{
	pixel_y = 8
	},
/obj/structure/table/wood/fancy/black,
/turf/open/floor/pod/dark,
/area/misc/survivalpod)
"aj" = (
/obj/structure/table/wood/fancy/black,
/obj/item/clipboard{
	pixel_y = 8
	},
/obj/item/toy/figure/bartender{
	pixel_y = 8
	},
/turf/open/floor/pod/dark,
/area/misc/survivalpod)
"ak" = (
/obj/structure/table/wood/fancy/black,
/obj/item/storage/fancy/cigarettes/cigars{
	pixel_y = 8
	},
/obj/item/storage/fancy/cigarettes/cigars/cohiba{
	pixel_y = 12
	},
/obj/item/storage/fancy/cigarettes/cigars/havana{
	pixel_y = 16
	},
/turf/open/floor/pod/dark,
/area/misc/survivalpod)
"al" = (
/obj/structure/reagent_dispensers/beerkeg,
/turf/open/floor/pod/dark,
/area/misc/survivalpod)
"am" = (
/obj/machinery/light/directional/north,
/obj/structure/closet/secure_closet/bar/all_access,
/turf/open/floor/pod/dark,
/area/misc/survivalpod)
"an" = (
/obj/structure/disposalpipe/trunk{
	dir = 4
	},
/obj/machinery/disposal/bin,
/turf/open/floor/pod/dark,
/area/misc/survivalpod)
"ao" = (
/obj/structure/disposalpipe/junction{
	dir = 4
	},
/turf/closed/wall/mineral/titanium/survival/pod,
/area/misc/survivalpod)
"ap" = (
/obj/machinery/door/airlock/survival_pod/glass,
/obj/effect/mapping_helpers/airlock/access/any/service/bar,
/obj/effect/mapping_helpers/airlock/access/any/supply/mining,
/obj/structure/fans/tiny,
/turf/open/floor/pod/dark,
/area/misc/survivalpod)
"aq" = (
/turf/open/floor/pod/dark,
/area/misc/survivalpod)
"ar" = (
/obj/structure/disposalpipe/segment,
/turf/closed/wall/mineral/titanium/survival/nodiagonal,
/area/misc/survivalpod)
"as" = (
/obj/structure/table/reinforced,
/obj/item/lighter{
	pixel_x = -4;
	pixel_y = 12
	},
/obj/item/lighter{
	pixel_y = 8
	},
/turf/open/floor/pod/dark,
/area/misc/survivalpod)
"at" = (
/obj/structure/table/reinforced,
/turf/open/floor/pod/dark,
/area/misc/survivalpod)
"au" = (
/obj/structure/table/reinforced,
/obj/item/storage/box/matches{
	pixel_x = -4;
	pixel_y = 16
	},
/turf/open/floor/pod/dark,
/area/misc/survivalpod)
"av" = (
/obj/machinery/door/window/survival_pod/left/directional/south{
	req_one_access = list("bar","mining")
	},
/turf/open/floor/pod/dark,
/area/misc/survivalpod)
"aw" = (
/obj/effect/turf_decal/mining/survival,
/turf/closed/wall/mineral/titanium/survival/nodiagonal,
/area/misc/survivalpod)
"ax" = (
/obj/structure/chair/stool/bar/directional/north,
/turf/open/floor/carpet/black,
/area/misc/survivalpod)
"ay" = (
/turf/open/floor/carpet/black,
/area/misc/survivalpod)
"az" = (
/obj/machinery/vending/cigarette{
	onstation = 0
	},
/turf/open/floor/carpet/black,
/area/misc/survivalpod)
"aA" = (
/obj/structure/disposalpipe/trunk{
	dir = 4
	},
/obj/machinery/disposal/bin,
/turf/open/floor/carpet/black,
/area/misc/survivalpod)
"aB" = (
/obj/structure/disposalpipe/segment{
	dir = 9
	},
/turf/closed/wall/mineral/titanium/survival/nodiagonal,
/area/misc/survivalpod)
"aC" = (
/obj/effect/spawner/structure/window/survival_pod,
/turf/open/floor/pod/dark,
/area/misc/survivalpod)
"aD" = (
/obj/structure/chair/comfy/black,
/turf/open/floor/carpet/black,
/area/misc/survivalpod)
"aE" = (
/obj/machinery/door/airlock/survival_pod,
/turf/open/floor/pod/light,
/area/misc/survivalpod)
"aF" = (
/obj/structure/table/wood/fancy,
/obj/item/reagent_containers/condiment/peppermill{
	pixel_x = -4;
	pixel_y = 12
	},
/obj/item/reagent_containers/condiment/saltshaker{
	pixel_x = 4;
	pixel_y = 4
	},
/turf/open/floor/carpet/black,
/area/misc/survivalpod)
"aG" = (
/obj/structure/toilet{
	dir = 4
	},
/turf/open/floor/pod/light,
/area/misc/survivalpod)
"aH" = (
/obj/structure/urinal/directional/west,
/turf/open/floor/pod/light,
/area/misc/survivalpod)
"aI" = (
/obj/machinery/light/small/directional/east,
/obj/structure/mirror/directional/north,
/obj/structure/sink/directional/south,
/turf/open/floor/pod/light,
/area/misc/survivalpod)
"aJ" = (
/obj/structure/table/reinforced,
/obj/item/storage/box/matches{
	pixel_x = -4;
	pixel_y = 8
	},
/turf/open/floor/pod/dark,
/area/misc/survivalpod)
"aK" = (
/obj/structure/chair/comfy/black{
	dir = 1
	},
/turf/open/floor/carpet/black,
/area/misc/survivalpod)
"aL" = (
/obj/machinery/vending/snack/blue{
	req_access = null;
	onstation = 0
	},
/turf/open/floor/carpet/black,
/area/misc/survivalpod)
"aM" = (
/obj/machinery/light/directional/south,
/turf/open/floor/carpet/black,
/area/misc/survivalpod)
"aN" = (
/obj/item/soap/deluxe,
/obj/machinery/light/small/directional/east,
/obj/machinery/shower/directional/south,
/turf/open/floor/pod/light,
/area/misc/survivalpod)
"aO" = (
/obj/structure/table/reinforced,
/obj/structure/window/reinforced/survival_pod/spawner/directional/south,
/turf/open/floor/pod/dark,
/area/misc/survivalpod)
"aP" = (
/obj/effect/turf_decal/mining/survival,
/turf/closed/wall/mineral/titanium/survival/pod,
/area/misc/survivalpod)
"aQ" = (
/obj/effect/turf_decal/mining/survival{
	dir = 4
	},
/turf/closed/wall/mineral/titanium/survival/pod,
/area/misc/survivalpod)
"aR" = (
/obj/machinery/door/airlock/survival_pod/glass,
/obj/structure/fans/tiny,
/turf/open/floor/carpet/black,
/area/misc/survivalpod)
"aS" = (
/obj/structure/window/reinforced/survival_pod/spawner/directional/west,
/obj/structure/window/reinforced/survival_pod/spawner/directional/east,
/obj/structure/window/reinforced/survival_pod/spawner/directional/north,
/obj/structure/window/reinforced/survival_pod/spawner/directional/south,
/obj/structure/grille,
/turf/open/floor/pod/dark,
/area/misc/survivalpod)
"aT" = (
/obj/structure/curtain{
	alpha = 240;
	color = "#454545";
	icon_state = "bathroom-closed";
	open = 0
	},
/obj/item/soap/deluxe,
/obj/machinery/light/small/directional/east,
/obj/machinery/shower/directional/south,
/turf/open/floor/pod/light,
/area/misc/survivalpod)
"aU" = (
/obj/structure/sink/directional/east,
/obj/structure/mirror/directional/west,
/turf/open/floor/pod/light,
/area/misc/survivalpod)
"aV" = (
/obj/effect/turf_decal/mining/survival{
	dir = 4
	},
/obj/structure/disposalpipe/segment,
/turf/closed/wall/mineral/titanium/survival/nodiagonal,
/area/misc/survivalpod)
"aW" = (
/obj/structure/table/wood/fancy/black,
/obj/machinery/chem_dispenser/drinks,
/turf/open/floor/pod/dark,
/area/misc/survivalpod)
"aX" = (
/obj/effect/turf_decal/mining/survival{
	dir = 8
	},
/turf/closed/wall/mineral/titanium/survival/nodiagonal,
/area/misc/survivalpod)
"aY" = (
/obj/effect/turf_decal/mining/survival{
	dir = 4
	},
/turf/closed/wall/mineral/titanium/survival/nodiagonal,
/area/misc/survivalpod)
"aZ" = (
/obj/structure/table/reinforced,
/obj/item/lighter{
	pixel_x = -4;
	pixel_y = 4
	},
/obj/item/lighter,
/turf/open/floor/pod/dark,
/area/misc/survivalpod)
"fb" = (
/obj/structure/table/wood/fancy/black,
/obj/machinery/chem_dispenser/drinks/beer,
/obj/machinery/light/directional/north,
/turf/open/floor/pod/dark,
/area/misc/survivalpod)
"fs" = (
/obj/item/book/manual/wiki/barman_recipes,
/obj/item/reagent_containers/cup/glass/shaker,
/obj/item/reagent_containers/cup/rag,
/obj/structure/table/wood/fancy/black,
/turf/open/floor/pod/dark,
/area/misc/survivalpod)
"hm" = (
/obj/structure/table/wood/fancy/black,
/obj/item/clipboard,
/obj/item/toy/figure/bartender,
/turf/open/floor/pod/dark,
/area/misc/survivalpod)
"kq" = (
/obj/effect/turf_decal/mining/survival{
	dir = 1
	},
/turf/closed/wall/mineral/titanium/survival/nodiagonal,
/area/misc/survivalpod)
"vy" = (
/obj/effect/turf_decal/mining/survival{
	dir = 1
	},
/turf/closed/wall/mineral/titanium/survival/pod,
/area/misc/survivalpod)
"Fx" = (
/obj/effect/turf_decal/mining/survival{
	dir = 4
	},
/obj/structure/disposalpipe/junction{
	dir = 4
	},
/turf/closed/wall/mineral/titanium/survival/pod,
/area/misc/survivalpod)
"KB" = (
/obj/structure/table/wood/fancy/black,
/obj/structure/reagent_dispensers/beerkeg,
/turf/open/floor/pod/dark,
/area/misc/survivalpod)
"YI" = (
/obj/structure/table/wood/fancy/black,
/obj/item/storage/fancy/cigarettes/cigars,
/obj/item/storage/fancy/cigarettes/cigars/cohiba{
	pixel_y = 4
	},
/obj/item/storage/fancy/cigarettes/cigars/havana{
	pixel_y = 8
	},
/turf/open/floor/pod/dark,
/area/misc/survivalpod)

(1,1,1) = {"
aa
aX
ap
aX
ac
aX
aS
aX
aS
aX
aa
"}
(2,1,1) = {"
vy
aW
aq
aZ
ae
ay
aD
aF
aK
aL
aP
"}
(3,1,1) = {"
ac
fb
aq
at
ae
ay
ay
ay
ay
aM
ac
"}
(4,1,1) = {"
kq
ah
aq
at
ae
ay
aD
aF
aK
ay
aw
"}
(5,1,1) = {"
ac
fs
aq
aJ
ae
ay
aD
aF
aK
ay
aS
"}
(6,1,1) = {"
kq
hm
aq
at
ae
ay
ay
ay
ay
ay
aR
"}
(7,1,1) = {"
ac
YI
aq
at
ae
ay
aD
aF
aK
ay
ac
"}
(8,1,1) = {"
kq
KB
aq
at
ae
ay
ac
ac
ac
ac
aw
"}
(9,1,1) = {"
ac
am
aq
av
ay
ay
aE
aU
aE
aG
ac
"}
(10,1,1) = {"
vy
an
aq
at
az
aA
ac
ad
ac
aT
ac
"}
(11,1,1) = {"
aa
Fx
ar
aV
ar
ab
ac
aY
ac
aQ
aa
"}
